ability	Fähigkeit
ability to learn	Fähigkeit zu lernen
a bit	ein bisschen
able	imstande
able to do something	imstande etwas zu tun
aboard	an Bord
a book	ein Buch
about three o'clock	ungefähr um drei Uhr
about	ungefähr
above 100	mehr als 100
above-mentioned	obenerwähnt
above the trees	über den Bäumen
a bowl of milk	eine Schale Milch
a boy of matches	eine Schachtel Zündhölzer
abroad	ins Ausland
absence	Abwesenheit
absent	abwesend
absent-minded	geistesabwesend
absolutely necessary	unbedingt erforderlich
absolutely nothing	überhaupt nichts
absolutely	unbedingt
accept	annehmen
accept a present	ein Geschenk annehmen
accept a suggestion	eine Anregung annehmen
accident	Unfall
accompany	begleiten
accordingly	dementsprechend
according to	entsprechend
according to plan	plangemäß
account	Konto
accustomed to the cold	an die Kälte gewöhnt
ache	weh tun
achieve	zustandebringen
acid	sauer
a clean shirt	ein sauberes Hemd
a clever person	eine geschickte Person
a close friend	ein enger Freund
a cloth with a gray stripe	Tuch mit einem grauen Streifen
a coloured print	ein Farbendruck
a couple of	ein paar
acquainted	bekannt
acquire	erwerben
a criminal act	ein Verbrechen
across the road	über die Straße
across	über
a crowded room	ein überfüllter Raum
action	Handlung
active	aktiv
activity	Aktivität
actor	Schauspieler
actress	Schauspielerin
act	Tat
actual	tatsächlich
a curl of hair	eine Haarlocke
a day's journey	eine Tagereise
address	Adresse
add	zusammenzählen
a debt of ten pounds	eine Schuld von zehn Pfund
a deep meaning	eine tiefe Bedeutung
admiration	Bewunderung
admire	bewundern
admission	Zugang
admit	einlassen
adopt	adoptieren
adoption	Adoption
a drop of oil	ein Tropfen Öl
a dry book	ein trockenes Buch
a dry cloth	ein trockenes Tuch
a dry form of humour	eine trockene Art von Humor
a dull boy	ein unintelligenter Junge
a dull stream	ein träger Fluss
adult	Erwachsener
a Dutchman	ein Holländer
a Dutchwoman	eine Holländerin
advance of prices	Zunahme der Preise
advance	Zunahme
advantage	Vorteil
adventure	Abenteuer
advertise	annoncieren
advertisement	Zeitungsanzeige
advertising	Werbung
advice	Rat
advise	beraten
advised me well	beriet mich gut
a eager eye	ein scharfes Auge
a	einer
aeroplane	Flugzeug (Br.)
a faint smell	ein schwacher Geruch
a faithful copy	eine getreue Kopie
a fall in prices	ein Nachlassen der Preise
a familiar article	ein bekannter Artikel
a familiar friend	ein vertrauter Freund
a fat sheep	ein fettes Schaf
a few	ein paar
affair	Angelegenheit
afford a car	sich ein Auto leisten können
afford a holiday	sich einen Urlaub leisten können
a flat plain	eine flache Ebene
Africa	Afrika
African	afrikanisch
after hours	nach Stunden
after	nach (zeitlich)
afternoon	Nachmittag
after the meal	nach der Mahlzeit
afterwards	nachher
against a post	gegen einen Pfosten
against	gegen
again	wieder
a garden behind the house	ein Garten hinter dem Haus
a garden rake	ein Gartenrechen
age	Alter
aged	gealtert
agency	Vertretung
agent	Vertreter
a girl on each arm	ein Mädchen in jedem Arm
a good many	eine Menge
a grain of sand	ein Sandkorn
a great deal	sehr viel
a great many	sehr viele
agreement	Übereinstimmung
agree	übereinstimmen
agricultural	landwirtschaftlich
agriculture	Landwirtschaft
ahead	voraus
aid	Hilfe
aim at something	zielen (auf etwas)
aimless	ziellos
aim	Ziel
aircraft	Flugzeug
airline	Fluglinie
air	Luft
airmail	Luftpost
airplane	Flugzeug (Am.)
airport	Flugplatz
airtight	luftdicht
a just man	ein gerechter Mann
a knife to cut bread with	Messer zum Brotschneiden
a large family	eine große Familie
alarm	Alarm
alarm clock	Wecker
alcohol	Alkohol
alike	gleich
a line of print	eine Druckzeile
a little	etwas
a little house	ein Häuschen
alive	am Leben
all at once	sofort
all day	den ganzen Tag
all	ganz
all men	alle Leute
all men are equal	alle Menschen sind gleichwertig
all night long	die ganze Nacht
allowance	Taschengeld
allow	erlauben
all the peoples of the earth	alle Völker der Erde
all the peoples of the world	alle Völker der Welt
all through	durch und durch
almost always	fast immer
almost	fast
almost perfect	nahezu perfekt
a loaf of bread	ein Laib Brot
alone	allein
a long drop down	ein Tiefer Fall
along	entlang
along the road	die Straße entlang
a long time ago	vor langer Zeit
a lot of	eine Menge
aloud	laut
a lover of nature	ein Naturliebhaber
already	schon
also	auch
although	obwohl
altogether	völlig
a lucky person	ein glücklicher Mensch
always	immer
amazing	erstaunlich
am	bin
ambulance	Krankenwagen
a mean trick	ein fauler Trick
America	Amerika
American	amerikanisch
American Indian	Indianer
among friends	unter Freunden
amongst	zwischen
among	zwischen
amount	Betrag
amount to	sich belaufen auf
amuse	amüsieren
amusement	Vergnügen
amuse yourself	amüsier dich
an African tribe	ein afrikanischer Stamm
an apple	ein Apfel
a narrow escape	ein knappes Entkommen
a narrow road	eine schmale Straße
ancient	antik
and so forth	und so fort
and so on	und so weiter
and	und
and yet you have done nothing	und hast doch nichts getan
an earnest worker	ein ernsthafter Arbeiter
an easy life	ein bequemes Leben
an	einer
an electrical engineer	ein Elektroingenieur
an Englishman	ein Engländer
an English woman	eine Engländerin
anew	aufs Neue
an exact observer	ein scharfer und genauer Beobachter
angel	Engel
angels in heaven	Engel im Himmel
anger	Zorn
angry	zornig
animal	Tier
animal world	Tierwelt
an iron bar	eine Eisenstange
annoyance	Verärgerung
annoying	ärgerlich
annoy	verärgern
an oil drum	ein Ölfass
another man	ein anderer Mann
another	noch einer
answer	beantworten
anxiety	Furcht
anxious	verunsichert
anybody	jemand
anyhow	jedenfalls
any	irgendeiner
anyone	jemand
anything	etwas beliebiges
anyway	in jedem Falle
anywhere	irgendwo
a pale face	ein blasses Gesicht
apart	getrennt
a piece of furniture	ein Möbelstück
a pinch of salt	eine Prise Salz
a pleasant evening	ein angenehmer Abend
apologize	um Entschuldigung bitten
apology	Entschuldigung
appearance	Erscheinen
appear	scheinen
appetite	Appetit
applaud	applaudieren
applause	Applaus
apple	Apfel
application	Bewerbung
apply	anwenden
apply for a job	sich um eine Stelle bewerben
apply for	sich bewerben um
apply to	sich wenden an
appoint	ernennen
appointment	Verabredung
appreciate	hochschätzen
appreciation	Würdigung
approach	sich nähern
approve of	billigen
a present	ein Geschenk
a pretty face	ein schönes Gesicht
April	April
a quarter past	Viertel nach
a quarter to	Viertel vor
a quiet conscience	ein ruhiges Gewissen
a quiet village	ein ruhiges Dorf
a rare event	ein seltenes Ereignis
arch	Bogen
area	Fläche
are	sind
argue	sich herumstreiten
argument	Streit
arise (irr.)	sich erheben
arisen	erhoben
arm	Arm
armchair	Sessel
armed men	bewaffnete Leute
armour	Rüstung eines Ritters
arms	Waffen
army	Heer
a roll of paper	eine Rolle Papier
arose	erhob sich
around	um herum
a row of people	eine Reihe Leute
arrangement	Reservierung
arrange	planen
arrest	Verhaftung
arrival	Ankunft
arrive	ankommen
arrow	Pfeil
article	Artikel
artificial	künstlich
artistic	künstlerisch
artist	Künstler
art	Kunst
as...as	so...wie
as for him	was ihn betrifft
ashamed	beschämt
ashamed of something	beschämt wegen etwas
ash	Asche
a sheet of paper	ein Blatt Papier
ashes	Asche
Asia	Asien
aside	beiseite
as if	als ob
ask for something	ums etwas bitten
ask	fragen
ask if he has come	frag ob er gekommen ist
ask somebody to dinner	jemanden zum Essen einladen
asleep	schlafend
a small amount of sugar	eine kleine Menge Zucker
a square mile	Quadratmeile
a square piece	ein viereckiges Stück
assistant	Assistent
assist	helfen
association	Verein
as soon as	so bald wie
as though	als ob
astonished	erstaunt
astonish	erstaunen
astonishing	erstaunlich
astonishment	Erstaunen
a straight line	eine gerade Linie
a strip of paper	ein Streifen Papier
as well as	so gut wie
as	wie
at all	überhaupt
at any rate	wenigstens
at	bei
at church	beim Gottesdienst
ate	aß
at first	zuerst
at hand	zur Hand
at high pressure	unter hohem Druck
a thing of this nature	etwas von dieser Art
at his side	neben ihm
at home	zu Hause
at last	endlich
at least	wenigstens
at my expense	auf meine Kosten
at nine o'clock	um neun Uhr
at once	sofort
attack	Angriff
attempt	versuchen
attend a conference	an einer Konferenz teilnehmen
attend school	Schule besuchen
attention	Aufmerksamkeit
attentive	aufmerksam
at the bottom of	am Boden von
at the close of the play	am Ende des Stücks
at the first try	beim ersten Versuch
at the front	vorn
at the head of	an der Spitze von
at the hotel	im Hotel
at the top	oben
at the top of	oben auf
attraction	Attraktion
attractive	attractiv
attract	reizen
a turn of the wheel	eine Drehung des Rades
audience	Publikum
August	August
aunt	Tante
Australia	Australien
Austrian	österreichisch
Austria	Österreich
author	Verfasser
autumn	Herbst(Br.)
available	verfügbar
avenue	Allee
average	Durchschnitt
average price	Durchschnittspreis
a very common flower	eine sehr gewöhnliche Blume
avoidable	vermeidbar
avoid	vermeiden
await	erwarten
awake	wach
away	weg
awful	furchtbar
awkward	scheußlich
a woman's skirt	der Rock einer Frau
a wooden box	eine hölzerne Kiste
a word of caution	ein Wort der Warnung
baby	Baby
back and forth	hin und her
backbone	Rückgrat
background	Hintergrund
back up	unterstützen
backward	rückständig
backwards	rückwärts
backyard	Hinterhof
back	zurück
bacon	Speck
bad luck	Unglück
bad	schlimm
bad work	schlechte Arbeit
baggage	Gepäck
bag	Tasche
bake	backen
baker	Bäcker
balance	Gleichgewicht
ball	Kugel
ball pen	Kugelschreiber
banana	Banane
band	Musikkapelle
bank	Geldinstitut
bank note	Geldschein
barber	Herrenfriseur
barely	kaum
bare	nackt
bargain	handeln
bark	bellen
barrel	Fass
bar	versperren
base	Basis
basement	Untergeschoss
basin	Becken
basis	Basis
basket	Korb
bath	Bad
bathe	baden
bathroom	Badezimmer
battle	Schlacht
bay	Bucht
be able to	können
be about to	im Begriff sein zu
beach	Strand
be afraid of	Angst haben vor
beak	Schnabel
be alive	leben
be allowed to	dürfen
bean	Bohne
beard	Bart
bear (irr.)	tragen
be asleep	schlafen
be astonished	erstaunt sein
beast	wildes Tier
beaten	geschlagen
beat (irr.)	schlagen
beat	schlug
beautifully	auf schöne Weise
beautiful	schön
beauty	Schönheit
became	wurde
be capable of	fähig sein zu
because of	wegen
because	weil
become	geworden
become (irr.)	werden
bed	Bett
bed of a river	Flußbett
bedroom	Schlafzimmer
bee	Biene
beef	Rindfleisch
be engaged	beschäftigt sein mit
been	gewesen
beer	Bier
be fond of	gerne haben
be forced to	müssen
before 1980	vor 1980
before	vorher
began	begann
beg	bitten
beggar	Bettler
begin (irr.)	beginnen
beginning	Anfang
begin to cry	zu schreien anfangen
begun	begonnen
behave	sich benehmen
behaviour	Benehmen
behind the mountains	hinter den Bergen
behind	zurück (hinten)
be in charge of	beaufsichtigen
being	Wesen
be in love (with)	verliebt sein (in)
be interested in	sich interessieren
Belgium	Belgien
belief	Glauben
believe	glauben
bell	Glocke
belong to	gehören
below the surface	unter der Oberfläche
below	unter
belt	Gürtel
be missing	fehlen
be mistaken	sich irren
bench	Sitzbank
bend (irr.)	biegen
bend	Kurve
beneath	unter (nur in literarischer Sprache)
bent	gebogen
be obliged to	müssen
be permitted to	dürfen
be right	recht haben
berry	Beere
be seated	sitzen
be	sein
beside	neben
besides	neben
best	bester
be suited	sich eignen
be tired of	satt haben
bet (irr.)	wetten
better	besser
between two persons	zwischen zwei Personen
between	zwischen
bet	wettete
be used to	gewohnt sein
be wrecked	Schiffbruch erleiden
be wrong	unrecht haben
beyond	jenseits
Bible	Bibel
bicycle	Fahrrad
big	groß
bike	Fahrrad
bill	Rechnung
bind (irr.)	binden
bind together	zusammenbinden
bird	Vogel
birthday card	Geburtstagskarte
birthday	Geburtstag
birth	Geburt
bit	biß
bite (irr.)	beißen
biting wind	beißender Wind
bitten	gebissen
bitter	bitter
bitterness	bitterer Geschmack
blackboard	Wandtafel
black	schwarz
blade	Klinge
blade of grass	Blatt vom Gras
blame	die Schuld geben
blanket	Wolldecke
bled	geblutet
bleed (irr.)	bluten
blessed	gesegnet
blessing	Segen
bless	segnen
blew	wehte
blind	blind
blinded	erblindet
blind man	Blinder
blind rage	blinder Zorn
block	blockieren
blood	Blut
blood-red	blutrot
bloody	blutig
bloom	Blüte
blossom	Blütenpracht
blouse	Bluse
blow (irr.)	wehen
blown	geweht
blow	Schlag
blow up	explodieren
blue	blau
blunt	stumpf
board	Vorstand
boastful	prahlerisch
boast	prahlen
boat	Boot
bodily	körperlich
body-guard	Leibwache
body	Körper
boiled potatoes	Pellkartoffeln
boiling point	Siedepunkt
boil	sieden
bold	kühn
boldly	in mutiger Weise
bold type	fette Druckbuchstaben
bomb	Bombe
bone	Knochen
book	Buch
booking office	Fahrkartenschalter
bookkeeper	Buchhalter
bookkeeping	Buchführung
bookshelf	Regal
bookshop	Buchhandlung
books of reference	Nachschlagewerke
boot	Stiefel
border	Grenze
border-line	Grenzlinie
bore	trug
boring	langweilig
borne	getragen
born	geboren
borrow	borgen
boss	Chef
both and	sowohl...als auch
both	beide
both my friends	meine beiden Freunde
bottle	Flasche
bottom of the sea	Meeresboden
bought	kaufte
boundary	Abgrenzung
bounded by the sea	umgeben von der See
bound	gebunden
bowl	Schale
bow	Verbeugung
box	Schachtel
boyfriend	Freund eines Mädchens
boy	Junge
brain	Gehirn
brains	Verstand
brain-worker	Geistesarbeiter
branch	Zweig
brass	Messing
bravely	auf tapfere Weise
brave	tapfer
bread	Brot
bread-knife	Brotmesser
breadth	Breite
break down	zusammenbrechen
breakdown	Zusammenbruch
breakfast	Frühstück
break (irr.)	zerbrechen
break	Pause
breast	Brust
breath	Atem
breathe	atmen
breathing	atmend
bred	züchtete
breed (irr.)	züchten
bribe	bestechen
bribery	Bestechung
brick	Ziegelstein
bride	Braut
bridegroom	Bräutigam
bridge	Brücke
bright	strahlend
bring about	zuwege bringen
bring back	zurückbringen
bring (irr.)	herbeibringen
British	britisch
broad	breit
broadcast (irr.)	senden (im Radio)
broadcast	sendete
broke	brach
broken	kaputt
brook	Bach
broom	Besen
brother	Bruder
brotherhood	Bruderschaft
brother-in-law	Schwager
brought	gebracht
brown	bräunen
browned by the sun	gebräunt von der Sonne
brush	Pinsel
bucket	Eimer
building	Gebäude
build (irr.)	bauen
built	gebaut
bulb	Glühbirne
bull	Stier
bunch of flowers	Blumenstrauß
bunch	Strauß
bundle	Bündel
burden	Last
burglar	Einbrecher
burial	Beerdigung
burn	Brandwunde
burning	Verbrennen
burn (irr.)	verbrennen
burnt	gebrannt
burst (irr.)	platzen
burst	platzte
bury	begraben
bus	Bus
bush	Busch
bushy	buschig
business	Geschäft
businessman (irr.)	Geschäftsmann
businessmen (pl.)	Geschäftsleute
bus stop	Bushaltestelle
busy	geschäftig
butcher	Fleischer
but	sondern
butter	Butter
butterfly	Schmetterling
button	Knopf
button up	zuknöpfen
buy (irr.)	kaufen
by accident	zufällig
by air	auf dem Luftweg
by birth	von Geburt an
by bus	mit dem Bus
by car	mit dem Auto
by chance	zufällig
by day	während des Tags
by electricity	mit Elektrizität
by heart	auswendig
by night	nachts
by no means	keineswegs
by plane	mit dem Flugzeug
by Shakespeare	von Shakespeare
by train	mit dem Zug
by	vorbei an
cabbage	Kohl
cable	Kabel
cafe	Cafe
cage	Käfig
cake	Kuchen
calculated	berechnet
calculate	rechnen
calculating	berechnend
calculation	Berechnung
calf	Wade
call for somebody	jemanden kommen lassen
call on somebody	jemanden besuchen
call	rufen
call the police	rufe die Polizei
calm down	beruhigen
calmly	in ruhiger Weise
calmness	Ruhe
calm	ruhig
calm weather	ruhiges Wetter
calves	Waden
came	kam
camera	Fotoapparat
camp-fire	Lagerfeuer
camping	Camping
camp	lagern
campsite	Campingplatz
canal	Schiffahrtskanal
candle	Kerze
can	Konservendose (US)
cannot	könnt nicht
can't	könnt nicht
cape	Kap
capital	Kapital
cap	Mütze
captain	Kapitän
card	Karte
care for	sich etwas machen aus
careful	vorsichtig
careless	unvorsichtig
care	Sorgfalt
car-load	Wagenladung
carpet	Teppich
carriage paid	Fracht bezahlt
carriage	Transport
carrot	Möhre
carry on	fortfahren
carry out	durchführen
carry	transportieren
cart	karren
case	Sache
cash	Bargeld
castle	Schloss
catch a ball	einen Ball fangen
catch (irr.)	fangen
catch the train	den Zug erreichen
cathedral	Kathedrale
cat	Katze
cattle	Rindvieh
caught	gefangen
cause and effect	Ursache und Wirkung
cause	verursachen
caution	warnen
cautiously	in vorsichtiger Weise
cautious	vorsichtig
cave	Höhle
ceiling	Zimmerdecke
celebrate	feiern
celebration	Feier
cellar	Keller
cent	Cent
center	Zentrum (US)
centimetre	Zentimeter
central	zentral
centre of a circle	Mittelpunkt eines Kreises
centre	Zentrum
century	Jahrhundert
certainly	gewiß
certain	sicher
certainty	Gewißheit
chain	Kette
chain up the dog	kette den Hund an
chairman	Vorsitzender
chairperson	Vorsitzende
chair	Stuhl
chamber	Kammer
chance	Chance
change	wechseln
character	Charakter
charcoal	Holzkohle
charge a battery	eine Batterie aufladen
charged with a crime	eines Verbrechens angeklagt
charge	Gebühr
charming	reizend
charm	Reiz
cheap	billig
cheat	mogeln
check-list	Prüfliste
check	Überprüfung
cheek	Wange
cheer	aufmuntern
cheese	Käse
chemical combination	chemische Verbindung
chemist	Apotheker
cheque	Scheck (Br.)
cherry	Kirsche
chest	Kasten
chest of drawers	Kommode
chicken	Hähnchen
chief	hauptssächlich
chiefly	hauptsächlich
childhood	Kindheit
child (irr.)	Kind
childish	kindisch
childlike	kindlich
children	Kinder
chimney	Kamin
China	China
china	Porzellan
Chinese	chinesisch
Chinese (pl.)	Chinesen
Chinese (s.)	Chinese
chin	Kinn
chips	Pommes frites(Br.)
chocolate	Schokolade
chocolates	Pralinen
choice	Auswahl
choose (irr.)	wählen
chosen	gewählt
chose	wählte
Christian	christlich
Christmas day	Weihnachtstag
Christmas	Weihnachten
church	Kirche
church-yard	Friedhof
cigarette	Zigarette
cigar	Zigarre
cinema	Kino
circle around	umkreisen
circle	Kreis
circular	rund
citizen	Bürger
city hall	Rathaus(US)
city	Stadt
civil	bürgerlich
civilization	Zivilisation
civilized	zivilisiert
claim	Forderung
classes	Unterricht
classification	Klassifikation
classify	klassifizieren
class	Klasse
clean	saubermachen
clean your teeth	putze deine Zähne
clear	klären
clear sky	klarer Himmel
clear up a mess	ein Durcheinander aufräumen
clerk	Büroangestellter
clever	klug
cliff	Klippe
climate	Klima
climb	klettern
clock	Wanduhr
clockwork	Uhrwerk
close	schließen
close the door	schließe die Tür
close to	nahe bei
clothe	bekleiden
clothes	Kleider
clothing	Bekleidung
cloth	Stoff (Tuch)
cloud	Wolke
cloudy	bewölkt
club	Klub
coach	Reisebus
coal	Kohle
coarse cloth	grobes Tuch
coarse	grob
coast	Küste
coast-line	Küstenlinie
coat	Mantel
coat-pocket	Manteltasche
cock	Gockelhahn
coffee	Kaffee
coffee-pot	Kaffeekanne
coin	münzen
cold	Kälte
coldly	in einem kühlen Ton
coldness	Kühle
collar	Kragen
collection	Sammlung
collector	Sammler
collect	sammeln
college	Hochschule
colony	Kolonie
colour	farbig machen
combination	Kombination
combined	verbunden
combine	verbinden
comb	kämmen
come across	ausfindig machen
come along	beeile dich
come and see us	besuch uns
come down to earth	komm auf die Erde zurück
come	gekommen
come in !	herein !
come in	komm herein
come (irr.)	kommen
come out	herauskommen
come to an end	ein Ende finden
come to see	besuchen (kommen)
come to the point	zur Sache kommen
comfortable	bequem
comfort	Komfort
command	Kommando
commerce	Handel
commercial	kaufmännisch
committee	Ausschuss
common	gewöhnlich
commonsense	gesunder Menschenverstand
community	Gemeinschaft
companion	Gefährte
company	Kompanie
compare	vergleichen
comparison	Vergleich
compete	im Wettbewerb stehen
competing	rivalisierend
competition	Konkurrenz
competitor	Mitbewerber
complain	sich beklagen
complaint	Klage
complete	vollständig
complicated	kompliziert
composer	Komponist
compose	zusammensetzen
composition	Komposition
concerning	betreffend
concern	Unternehmen
concert	Konzert
conditional	konditidional
condition	Zustand
confess	gestehen
confidence	Vertrauen
confidential	vertraulich
confident	zuversichtlich
congratulate	gratulieren
congratulations	Glückwünsche
connected	verbunden
connection	Verbindung
connect	verbinden
conquered	erobert
conquer	erobern
conqueror	Eroberer
conscience	Gewissen
conscious	bewusst
consciousness	Bewusstsein
consequence	Folge
considerable	beträchtlich
consideration	Überlegung
consider	überlegen
consider well before you choose	überlege gut ehe du wählst
consist of	bestehen aus
construct	bauen
construction	Konstruktion
constructive	konstruktiv
contact somebody	mit jemand Kontakt aufnehmen
contact	Verbindung
contain	enthalten
container	Behälter
contented	zufrieden
contents	Inhalt
content	zufrieden
continent	Kontinent
continue	fortsetzen
continuously	ununterbrochen
contrary	Gegenteil
control	kontrollieren
convenience	Annehmlichkeit
convenient	geeignet
conversation	Unterhaltung
conviction	Überzeugung
convince	überzeugen
cooked	gekocht
cooking fat	Kochfett
cooking-stove	Küchenherd
cook	Köchin
cool	kühlen
copper	Kupfer
copy	Nachahmung
cord	Strick
cork	Korken
corkscrew	Korkenzieher
corner	Ecke
corn	Mais(US)
correction	Verbesserung
correctly	in richtiger Weise
correct	verbessern
cost (irr.)	kosten
cost	kostete
cost of living	Lebenshaltungskosten
cost price	Selbstkostenpreis
cottage	Hütte
cotton	Baumwolle
couch	Couch
cough	husten
could	könntet
council	Rat (Gremium)
country	Land
County Council	Grafschaftsrat
count	zählen
couple	Ehepaar
courage	Mut
courageous	mutig
course	Kurs
court	Hof
court of justice	Gerichtshof
cousin	Vetter
covering	bdeckend
cover	zudecken
coward	Feigling
cowardice	Feigheit
cowardly	in feiger Weise
cow	Kuh
crack	Riß
crash	zusammenstoßen
craziness	Verrücktheit
crazy	verrückt
cream	Sahne
create	schaffen
creature	Geschöpf
credit	Kredit
creep (irr.)	kriechen
crept	kroch
crime	Verbrechen
criminal	verbrecherisch
critical	kritisch
criticism	Kritik
critic	Kritiker
crop	Ernte
crossing	Überfahrt
cross	überqueren
crowded	überfüllt
crowd	Menschenmenge
crown	Krone
cruel	grausam
cruelly	auf grausame Weise
cruelty	Grausamkeit
crush	ausdrücken
cry out	aufschreien
cry	weinen
cultivated	gepflegt
cultivate	pflegen
culture	Kultur
cupboard	Geschirrschrank
cup	Tasse
cure	kurieren
curiosity	Neugier
curiously	in neugieriger Weise
curious	neugierig
curled	gekraust
curl	Locke
currency	Währung
current	Strömung
cursed	verflucht
curse	verfluchen
curtain	Vorhang
curve	Kurve
cushioned	mit Kissen versehen
cushion	Kissen
customary	üblich
custom	Brauch
customer	Kunde
customs duty	Zollabgaben
customs	Zollbehörde
cut (irr.)	schneiden
cut	schnitt
daily	täglich
dairy	Molkerei
damaged	beschädigt
damage	Schaden
damp	Feuchtigkeit
dance	tanzen
dancing-shoes	Tanzschuhe
dancing	Tanzen
danger	Gefahr
dangerous	gefährlich
dare	wagen
daring	mutig
dark	dunkel
darken	verdunkeln
dark gray	dunkelgrau
darkness	Dunkelheit
date	Verabredung
daughter-in-law	Schwiegertochter
daughter	Tochter
day after day	Tag für Tag
day-dream	Tagtraum
day	Tag
dead body	Leiche
dead	Tote
deafening	ohrenbetäubend
deaf person	Schwerhöriger
deaf	taub
deal	austeilen
deal him a blow	ihm einen Schlag versetzen
deal in (irr.)	handeln mit
dealt in	handelte mit
deal with a problem	eine Angelegenheit behandeln
dear brother	lieber Bruder
dear	lieb
dear mother	Liebe Mutter
Dear Sir	sehr geehrter Herr
deathbed	Totenbett
death	Tot
debt	Schuld
decay	verrotten
deceived	getäuscht
deceive	täuschen
December	Dezember
deception	Täuschung
decided	entschlossen
decide	entscheiden
decision	Entscheidung
decisive	entscheidend
declaration	Erklärung
declare	feststellen
decrease	abnehmen
deed	Tat
deep blue	tiefes Blau
deep sleep	tiefer Schlaf
deep	tief
deer	Rotwild
defeated	besiegt
defeat	Niederlage
defence	Verteidigung (Br.)
defend	verteidigen
defense	Verteidigung (Am.)
degree	Grad
delay	Verzögerung
delicacy	Delikatesse
delicately	auf zarte Weise
delicate	zart
delighted	erfreut
delight	Entzücken
delightful	entzückend
delightfully	in entzückender Weise
deliver	anliefern
delivered	angeliefert
deliver us from evil	erlöse uns von der Sünde
delivery	Anlieferung
delivery of a baby	Geburt eines Kindes
demand	verlangen
Denmark	Dänemark
dentist	Zahnarzt
deny	leugnen
depart	abreisen
department	Abteilung
department store	Kaufhaus
departure	Abreise
depend	abhängen
dependence	Abhängigkeit
dependent	abhängig
depend on	Abhängig sein von
depend on something	von etwas abhängen
depth	Tiefe
descend from	abstammen von
describe	beschreiben
description	Beschreibung
deserted	verlassen
desert	Wüste
deserve punishment	Strafe verdienen
deserve	verdienen
desire	wünschen
desk	Schreibtisch
despair	Verzweiflung
desperate	verzweifelt
destroy	zerstören
destruction	Zerstörung
destructive	zerstörerisch
detailed	detailliert
detail	Einzelheit
determination	Entschlossenheit
determined	entschlossen
determine	sich entschließen
development	Entwicklung
develop	sich entwickeln
devil	Teufel
dial	wählen (Telefon)
diamond	Diamant
dictate	diktieren
dictation	Diktat
dictator	Diktator
dictionary	Wörterbuch
did	tatest
die	sterben
difference	Unterschied
different	verschieden
differ	sich unterscheiden
difficult	schwierig
difficulty	Schwierigkeit
dig (irr.)	graben
dine	speisen
dining-car	Speisewagen
dining room	Speisezimmer
dinner	Abendessen
dinner is ready	das Essen ist fertig
dinner plate	großer flacher Teller
dinner-table	Speisezimmertisch
dip	senken
direction	Richtung
directions	Anweisungen
direct	lenken
directly	geradewegs
director	Leiter
direct somebody to some place	jemandem den Weg zeigen
dirt	Schmutz
dirty	schmutzig
disadvantage	Nachteil
disagree	nicht übereinstimmen
disappearance	Verschwinden
disappear	verschwinden
disappointed	enttäuscht
disappoint	enttäuschen
disappointment	Enttäuschung
discharge	Entlassung
discipline	Disziplin
discomfort	Unbequemlichkeit
discontented	unzufrieden
discontent	unzufrieden
discover	entdecken
discoverer	Entdecker
discovery	Entdeckung
discuss	diskutieren
discussion	Diskussion
disease	Leiden
dishes	Geschirr
dish	Speise
dish-washer	Geschirrspülmaschine
dislike	nicht mögen
dismissal	Entlassung
dismiss	entlassen
disorder	Unordnung
display	ausstellen
displeasure	Missfallen
dispute	Streit
disrespect	Nichtachtung
dissatisfy	nicht befriedigen
dissolve	sich auflösen
distance	Entfernung
distant	entfernt
distinguish	unterscheiden
distribute	verteilen
district	Bezirk
disturb	stören
ditch	Graben
diver	Taucher
dive	tauchen
divide by	dividieren durch
divided	geteilt
divided into parts	in Teile unterteilt
divide	teilen
diving outfit	Tauchausrüstung
division	Teilung
doctor	Doktor
document	Dokument
does she really care for him	liebt sie ihn wirklich
dog	Hund
do good	Gutes tun
do (irr.)	tun
dollar	Dollar
doll	Puppe
done	getan
donkey	Esel
door-bell	Türklingel
door	Tür
dot	Pünktchen machen
do	tut
double doors	Doppeltüren
double glazing	doppelte Verglasung
double	verdoppeln
double your money	verdoppele dein Geld
doubtful	fraglich
doubtless	ohne Zweifel
doubt	zweifeln
do up a parcel	ein Paket fertif machen
do without	verzichten auf
down	hinunter
downstairs	im unteren Stockwerk
down to the present day	bis heute
downwards	abwärts
do you know yet ?	weißt du schon ?
do your best	leiste dein Bestes
dozen	Dutzend
drag net	Schleppnetz
drag	schleppen
drank	trank
draw a line	eine Zeile ziehen
draw a line through a point	eine Linie durch einen Punkt ziehen
draw conclusions	Schlüsse ziehen
drawer	Schublade
draw from an account	von einem Konto abheben
drawing	Zeichnung
draw (irr.)	ziehen
drawn	gezogen
dream (irr.)	träumen
dream	Traum
dreamt	träumte
dreamy	verträumt
dressed all in white	ganz weiß gekleidet
dressed	angezogen
dressed in black	in Schwarz gekleidet
dressed in white	gekleidet in Weiß
dressed up	gut gekleidet
dress	sich anziehen
drew	zog
drink	Getränk
drink (irr.)	trinken
drink it up	trinke aus
drink to the health of the bride	auf das Wohl der Braut trinken
drive a nail into the wall	einen Nagel in die Wand schlagen
drive	Fahrt
drive (irr.)	Vieh treiben
driven	gefahren
driver	Fahrer
drop in	auf einen Besuch hereinkommen
drop off to sleep	in Schlaf versinken
drop	Tropfen
drove	fuhr
drown	ertrinken
drowning	Ertrinken
drug	Arzneimittel
drugs	Drogen
drumming	Trommeln
drum	trommeln
drunkard	Trinker
drunken	betrunken
drunk	getrunken
dryly	auf trockene Art und Weise
dryness	Trockenheit
dry	trocken
dry weather	trockenes Wetter
duck	Ente
due to a mistake	wegen eines Fehlers
due to	infolge
dug	grub
dullness	Flaute
dull	trübe
during	während
duster	Staublappen
dust	Staub
dusty	staubig
Dutch	niederländisch
duty paid	Zoll bezahlt
duty	Zoll
dwelling	Wohnstätte
dwell (irr.)	wohnen
dying	sterbend
each day	jeden Tag
each	jeder (einzelne)
each other	einander
eager	eifrig
eager for more work	auf mehr Arbeit begierig
eagerly	in begieriger Weise
early breakfast	frühes Frühstück
early	frühzeitig
early riser	Frühaufsteher
earnest	ernsthaft
earn	Geld verdienen
earnings	Verdienst
ear	Ohr
ear-ring	Ohrring
earthenware	Steingut
earth	Erde
earthquake	Erdbeben
earthworm	Regenwurm
ease	lindern
ease of mind	innere Ruhe
easily	auf leichte Weise
eastern	östlich
Easter	Ostern
East	Osten
easy	leicht zu tun
eaten	gegessen
eating and drinking	Essen und Trinken
eating	Essen
eating-house	Speiserestaurant
eat (irr.)	essen
economical	sparsam
economic	wirtschaftlich
economy	Wirtschaft
edge of a knife	Schneide eines Messers
edge	Schneide
educated	gebildet
educate	erziehen
education	Erziehung
educator	Erzieher
effect	Wirkung
effort	Anstrengung
egg	Ei
egg-white	Eiweiß
eight	acht
eighteen	achtzehn
eighteenth	achtzehnte
eighth	achte
eightieth	achtzigste
eighty	achtzig
either...or	entweder...oder
elastic	elastisch
elasticity	Elastizität
elbow	Ellenbogen
elder	ältere
eldest	älteste
elect a representative	einen Vertreter wählen
election	Wahl
electrical	elektrisch
electrical engineering	Elektrotechnik
electric current	elektrischer Strom
electric	elektrisch
electrician	Elektriker
electricity	Elektrizität
elect	wählen
element	Element
elephant	Elefant
elevator	Aufzug(US)
eleven	elf
eleventh	elfte
else	sonst noch
elsewhere	sonst wo
emergency	Notfall
employ	beschäftigen
employee	Arbeitnehmer
employer	Arbeitgeber
employment	Beschäftigung
emptied	entleert
emptiness	Leere
empty	leer
enclosed	umzäunt
enclose	umschließen
enclosure	Umzäunung
encourage	ermutigen
encouragement	Ermutigung
end	enden
endless	endlos
end of season sale	Saisonschlußverkauf
end of the day	Ende des Tages
end of the road	Ende der Straße
end of the year	Ende des Jahres
enemy	Feind
enemy ships	feindliche Schiffe
energy	Energie
engaged	verlobt
engagement ring	Verlobungsring
engagement	Verlobung
engine-driver	Lokomotivführer
engineer	Ingenieur
engineering	Technik
engine	Motor
England	England
English	englisch
enjoyable	erfreulich
enjoy	genießen
enjoyment	Genuß
enjoy oneself	sich (gut) amüsieren
enough	genug
enough has been said	es ist genug gesagt worden
enough to eat	genug zu essen
enquire	sich erkundigen
enquiry	Erkundigung
enter a name on a list	einen Namen auf einer Liste eintragen
enter	eintreten
entertainer	Unterhalter
entertaining	unterhaltend
entertainment	Unterhaltung
entertain	unterhalten
enter the church	in die Kirche eintreten
enter the room	den Raum betreten
entire happiness	vollkommenes Glück
entirely	gänzlich
entire	völlig
entrance	Eintrittsgeld
entrance fee	Beitrittsgebühr
entrance-hall	Eingangshalle
entrust	anvertrauen
entry	Eintritt
envelope	Briefumschlag
envious	neidisch
envy	Neid
equal	gleichwertig
equality	Gleichheit
equally	gleichermaßen
escaped	entflohen
escape	Flucht
escape of gas	Entweichen von Gas
escape out of prison	Flucht aus dem Gefängnis
especial	besonders
especially	insbesondere
essence	Wesen
essential	wesentlicher Bestandteil
established	fundiert
establish	gründen
establishment	Geschäft
estimate	schätzen
European	Europäer
Europe	Europa
evening	Abend
evening dress	Abendkleidung
even now	sogar jetzt
even	sogar
event	Ereignis
eventful	ereignisreich
ever	jemals
everlasting	ewig andauernd
ever other day	jeden zweiten Tag
ever since	seitdem
ever-widening interests	immer wachsende Interessen
everyday	an jedem Tag
every few hours	alle paar Stunden
every	jeder
everyone	jedermann
everything	alles
everywhere	überall
evil deeds	üble Taten
evil thoughts	böse Gedanken
evil	Übel
exact	genau
exam	Examen
examination	Examen
examine	prüfen
examiner	Prüfer
example	Vorbild
excellence	Vortrefflichkeit
excellent	ausgezeichnet
excellently	in ausgezeichneter Weise
except	außer
except by doing it yourself	außer du tust es selbst
except for a few mistakes	außer ein paar Fehlern
exception	Ausnahme
exchange	austauschen
exchange of prisoners	Austausch von Gefangenen
excite	aufregen
excitement	Aufregung
exciting	aufregend
excuse	Entschuldigung
excuse me	entschuldige mich
excuse me for interrupting	entschuldigen Sie die Störung
exercise	Übung
exhibit	ausstellen
exhibition	Ausstellung
exhibitor	Aussteller
existence	Dasein
exist	existieren
existing	bestehend
exit	Ausgang
exlosive	explosiv
expectation	Erwartung
expect	erwarten
expense	Ausgaben
expenses	Unkosten
expensive	teuer
experienced	erfahren
experience	Erfahrungen machen
experimental	experimentell
experimentally	durch Experimente
experiment	experimentieren
expert	Fachmann
expert opinion	Meinung des Fachmanns
explain	erläutern
explanation	Erläuterung
explode	explodieren
exploration	Erforschung
explore	erforschen
explorer	Forscher
explosion	Explosion
export	exportieren
express	ausdrücken
expression	Ausdruck
express train	D-Zug
extend	verlängern
extension	Verlängerung
extensive	extensiv
extensively	sich ausdehnend
extent	Ausmaß
extraordinarily	in außergewöhnlicher Weise
extraordinary	außergewöhnlich
extra	zusätzlich
extreem	Extrem
extreme	äußerster
eye	Auge
eye-ball	Augapfel
eyebrow	Augenbraue
eyelash	Wimpern
eyes filled with tears	mit Tränen gefüllte Augen
face	Gesicht
face-powder	Gesichtspuder
factory	Fabrik
factory-girl	Fabrikmädchen
factory-inspector	Fabrikinspektor
fact	Tatsache
faded flowers	verwelkte Blumen
fade	verwelken
failure	Misserfolg
fail	versagen
faint	ohnmächtig werden
fair	fair
faithfully	getreu
faithful	treu
faith	Glauben
fall asleep	einschlafen
fall	Herbst(US)
fall in love (with)	sich verlieben (in)
fall (irr.)	fallen
false	falsch
falsehood	Falschheit
false ideas	falsche Ideen
falsely	fälschlicherweise
false teeth	falsche Zähne
fame	Ruhm
familiar	vertraut
family	Familie
family-life	Familienleben
famous	berühmt
fancy articles	Modeartikel
fancy cakes	Törtchen
fancy costume	Maskenkostüm
fancy price	Phantasiepreis
fancy	sich vorstellen
fan	Fan
far away	weit weg
fare	Fahrpreis
farm	Bauernhof
farmer	Bauer
farmer's wife	Bäuerin
far-reaching	weitreichend
farther	weiter
farthest	am weitesten
far	weit
fashionable	modisch
fashion	Mode
fasten	festmachen
fast	schnell
fate	Schicksal
fat	Fett
father-in-law	Schwiegervater
father	Vater
fault	Mangel
favourable	günstig
favourably	in günstiger Weise
favour	Gunst
favourite	Favorit
fearful	furchtbar
fear	fürchten
fearless	furchtlos
feast	Fest
feather-bed	Federbett
feather	Vogelfeder
February	Februar
Federal Republic of Germany	Bundesrepublik Deutschland
fed	gefüttert
feed	Fütterung
feed (irr.)	füttern
feeling	Gefühl
feel (irr.)	fühlen
feel	sich fühlen
feet	Füße
fell	fiel
fellow	Kamerad
fellowship	Kameradschaft
felt	gefühlt
female	weiblich
fence off	abzäunen
fence	Zaun
fetch	holen
fever	Fieber
feverish	fieberhaft
feverishly	in fieberhafter Weise
few	wenige
field	Feld
fierce	heftig
fifteen	fünfzehn
fifteenth	fünfzehnte
fifth	fünfte
fiftieth	fünfzigste
fifty	fünfzig
fighter	Kämpfer
fight (irr.)	kämpfen
fight	Kampf
figure	Ziffer
fill	füllen
fill in	ausfüllen(Br.)
filling station	Tankstelle
fill out	ausfüllen(US)
fill up	auffüllen
film	Film
final	endgültig
finally	endlich
find	Fund
find (irr.)	finden
find out	herausbekommen
fine	fein
finely	auf feine Art
finger	Finger
finger-mark	Fingerabdruck
finger-nail	Fingernagel
finished	beendet
finish	Politur
firearms	Feuerwaffen
fire arms	Schusswaffen
fire	Feuer
fireproof	feuerfest
firm	Firma
firm ground	fester Boden
first class	erstklassig
first name	Vorname
first	zuerst
fisherman	Fischer
fish	fischen
fishing-rod	Angelrute
fish (pl.)	Fische
fish (sg.)	Fisch
fist	Faust
fitness	Tauglichkeit
fit	passen
five	fünf
fix	festmachen
fix up a shelf	ein Regal aufbauen
flag	Flagge
flame	Flamme
flash	blitzen
flatten	flach machen
flatter	schmeicheln
flattery	Schmeichelei
flat	Wohnung
flavour	Geschmack
fled	geflohen
flee (irr.)	fliehen
flesh	Fleisch (am menschlichen Körper)
flew	flog
flight	Flug
float	treiben
flooded	überschwemmt
flood	überfluten
floor	Stockwerk
flour	Mehl
flower bed	Blumenbeet
flower	Blume
flower-garden	Blumengarten
flower-pot	Blumentopf
flow	fließen
flown	geflogen
fly	Fliege
fly (irr.)	fliegen
fog	Nebel
fold	falten
follower	Verfolger
follow	verfolgen
fond of his sister	mag seine Schwester
food	Speise
foolishness	törichtes Benehmen
foolish	töricht
fool	Narr
football	Fußball
foot (irr.)	Fuß
footnote	Fußnote
footpath	Fußweg
footprint	Fußabdruck
for a little while	für eine kleine Weile
for a minute	eine Minute lang
forbade	verbot
forbidden	verboten
forbid (irr.)	verbieten
force	zwingen
forehead	Stirn
foreigner	Ausländer
foreign	fremd
foreign politics	Auslandspolitik
forest	Wald
for ever and ever	für alle Zeiten
forever	für immer
for example	zum Beispiel
for fear	aus Furcht
for fear that	aus Furcht daß
forgave	verzieh
forget (irr.)	vergessen
forgive (irr.)	verzeihen
forgiven	verziehen
forgotten	vergessen (part.)
forgot	vergaß
for instance	zum Beispiel
fork	Gabel
form a habit	sich etwas angewöhnen
formal	förmlich
formality	Formalität
former	ehemaliger
formerly	früher
form	Gestalt
for	nach (einem Ort)
for sale	zum Verkauf
for ...'s sake	um ... willen
for the good of all	zum Wohle aller
for the rest of the day	für den Rest des Tages
fortieth	vierzigste
fortnight	vierzehn Tage
fortunate	glücklich (günstig)
fortunately	glücklicherweise
fortune	Vermögen
forty	vierzig
for various reasons	aus verschiedenen Gründen
forwards	vorwärts
forward	vorwärts
fought	kämpfte
foundation	Gründung
found	gründen
fountain	Brunnen
fountain pen	Füllfederhalter
fourteenth	vierzehnte
fourteen	vierzehn
fourth	vierte
four	vier
fox	Fuchs
frame	Rahmen
France	Frankreich
freedom	Freiheit
freedom of the press	Pressefreiheit
free	frei
freely	großzügig
free trade	Freihandel
freeze (irr.)	frieren
French	französisch
french fries	Pommes frites(US)
Frenchman	Franzose
French (pl.)	Franzosen
Frenchwoman	Französin
frequent	häufig besuchen
freshen	erfrischen
fresh	frisch
freshness	Frische
Friday	Freitag
fridge	Kühlschrank
fried	gebraten (in Pfanne)
friend	Freundin
friendly	freundlich
friendship	Freundschaft
frighten	erschrecken
fright	Schrecken
from memory	aus dem Gedächtnis
from top to bottom	von oben bis unten
from ... to	von ... bis
from	von (... her)
front door	Haustür
frontier	Grenze
front	Vorderside
frost	Frost
froze	fror
frozen	gefroren
fruit-market	Obstmarkt
fruit	Obst
fruits preserved in syrup	in Sirup eingelegte Früchte
fruit-tree	Obstbaum
fry	in der Pfanne braten
frying-pan	Pfanne
full stop	Punkt am Satzende
full	voll
funeral	Beerdigung
funny	spaßig
fun	Spaß
furnish	möblieren
furniture	Möbel (pl.)
fur	Pelz
further	weiter
gain	gewinnen
gallery	Galerie
gallon	Gallone
game	Wildpret
gap	Spalte
garage	Reperaturwerkstatt
gardener	Gärtner
garden	Garten
gas	Gas
gas station	Tankstelle(US)
gate	Tor
gather	sammeln
gave	gab
gay	bunt
gay colours	bunte Farben
gay (happy)	lustig
geese	Gänse
general	General
generally	im allgemeinen
generosity	Großzügigkeit
generous	großzügig
generously	in großzügiger Weise
gentleman (irr.)	Herr
gentlemen	Herren
gentleness	Zartheit
gentle	zart
geography	Erdkunde
German Democratic Republic	Deutsche Demokratische Republik
German	Deutscher
Germany	Deutschland
get a cold	sich verkühlen
get along with	auskommen mit
get drunk	sich betrinken
get hold of	erwischen
get into trouble	in Schwierigkeiten kommen
get (irr.)	werden
get lost	verloren gehen
get on	weiterkommen
get permission	Erlaubnis bekommen
get ready	sich fertig machen
get rid of	loswerden
get to	gelangen
get up	aufstehen
get up early	früh aufstehen
ghost	Gespenst
gift	Geschenk
girlfriend	Freundin eines Mannes
girl	Mädchen
give a kiss	einen Kuss geben
give a sign	ein Zeichen geben
give back	zurückgeben
give in	nachgeben
give (irr.)	schenken
give it a trial	probiere es
give me a chance	gib mir eine Gelegenheit
given	gegeben
give notice	kündigen
give way	Platz machen
glad	froh
gladly	gerne
glance at something	einen Blick auf etwas werfen
glance	Blick
glasses	Brille
glass	Glas
glorious	herrlich
gloriously	in herrlicher Weise
glory	Ruhm
glove	Handschuh
go abroad	ins Ausland gehen
go after him	laufe ihm nach
go ahead	voran gehen
go along with me	komm mit mir
goal	Tor beim Fußball
goat	Ziege
go away	weggehen
go back	zurück gehen
go-between	Vermittler
go by tube	mit der U-Bahn fahren
goddess	Göttin
godfather	Pate
god	Gott
godmother	Patin
go in	geh hinein
go into	hinein gehen
go (irr.)	gehen
gold-dust	Goldstaub
golden age	goldenes Zeitalter
golden	golden
gold-fish	Goldfisch
gold	Gold
gold-mine	Goldbergwerk
gold-smith	Goldschmied
gone	gegangen
good afternoon !	Guten Tag ! (nachmittags)
goodbye !	Auf Wiedersehen !
good deeds	gute Taten
good enough	gut genug
good evening !	Guten Abend !
good-for-nothing	Tunichtsgut
good	gut
good lord !	mein Gott !
good luck !	Viel Glück !
good morning !	Guten Tag ! (vormittags)
goodness	Güte
good night !	Gute Nacht !
goods wagon	Güterwagen
goods	Waren
go on tour	auf Tour gehen
go on	weitermachen
goose	Gans
go out	ausgehen
gossip	Klatsch
got	bekommen
go to church	zur Kirche gehen
go to see	besuchen (gehen)
go to sleep	schlafen gehen
go toward the door	geh auf die Türe zu
government	Regierung
governor	Governeur
govern	regieren
graceful	graziös
grace	Gnade
gradual	allmählich
gradually	Stufe um Stufe
grain	Korn
grammar	Grammatik
gramme	Gramm
grandchild	Enkelkind
granddaughter	Enkelin
grandfather	Großvater
grand	großartig
grandmother	Großmutter
grandparents	Großeltern
grandson	Enkel
grant	gewähren
grape	Traube
grass	Gras
grateful	dankbar
grave	Grab
gravestone	Grabstein
gray	grau
grease	fetten
greasy	fettig
Great Britain	Großbritannien
great-grandfather	Urgroßvater
great	groß
greatness	Größe
Greece	Griechenland
greed	Gier
greedily	auf gierige Weise
greedy	gierig
Greek	griechisch
green	grün
green-house	Glashaus
greet	begrüßen
greeting	Begrüßung
greetings	Grüße
grew	züchtete
grill	grillen
grind (irr.)	mahlen
grindstone	Mahlstein
grocer	Lebensmittelhändler
ground floor	Erdgeschoß
groundless	bodenlos
ground	mahlte
group	gruppieren
grow (irr.)	züchten
grown	geworden
grown up	erwachsen
growth	Wachstum
grow up	erwachsen werden
guard	Wache
guess	raten
guest	Gast
guest-house	Gasthaus
guide	führen
guiltless	unschuldig
guilt	Schuld
guilty	schuldig
gun	Schusswaffe
gymnastic exercises	gymnastische Übungen
habit	Angewohnheit
had	hattet
hair-brush	Haarbürste
haircut	Haarschnitt
hairdo	Frisur
hairdresser	Friseur (Damen)
hair	Haar
hair-net	Haarnetz
half	halb
half (irr.)	Hälfte
half past five	halb sechs Uhr
hall	Saal
halves	Hälften
hammer	Hammer
ham	Schinken
handbook	Handbuch
handkerchief	Taschentuch
handle	umgehen mit
handshake	Händedruck
handsome	gutaussehend (von einem Mann)
hand	Uhrzeiger
handwriting	Handschrift
handy	handlich
hang (irr.)	hängen
hangman	Henker
hang together	zusammenhängen
hang up a picture	ein Bild aufhängen
happen	sich ereignen
happily	in glücklicher Weise
happiness	Glücksgefühl
happy	glücklich (selig)
harbour	Hafen
hard drinks	scharfe Getränke
harden	härten
hardly	kaum
hardness	Härte
hard	schwierig
hardship	harte Umstände
harmful	schädlich
harmless	harmlos
harm	Schaden
harvest	ernten
has	hat
haste	Eile
hasten	hasten
hasty	eilig
hate	hassen
hat	Hut
have a good time !	Viel Vergnügen !
have a try !	versuch es mal !
have got	haben
have	hast
have (irr.)	haben
hay	Heu
headache	Kopfweh
heading	Briefkopf
head	Kopf
headline	Schlagzeile
headmaster	Schulleiter
he agreed with me	er stimmte mit mir überein
heal	heilen
healing	Heilung
health	Gesundheit
healthy	gesund
heap	Haufen
heard	hörte
hearer	Hörer
hear (irr.)	hören
heartbeat	Herzschlag
heartbroken	gebrochenen Herzens
heartburn	Sodbrennen
heart	Herz
heartless	herzlos
hearty	herzlich
heat	Hitze
heating	Heizung
heaven	Himmel
heavenly	himmlisch
heavy	schwer an Gewicht
he collects stamps	er sammelt Briefmarken
he deals in shoes	er handelt mit Schuhen
he did it with ease	er schaffte es leicht
he does	er tut
he dropped a hint	er gab einen Wink
he dropped his title	er ließ seinen Titel weg
heel	Ferse
he enjoys good health	er erfreut sich guter Gesundheit
he	er
he exercised his muscles	er übte seine Muskeln
he found it funny	er fand es spaßig
he got first prize	er gewann den ersten Preis
he had nothing to do with it	er hatte damit nichts zu tun
he idles away his time	er verbringt seine Zeit tatenlos
height	Höhe
heir	der Erbe
he is afraid of the truth	er fürchtet sich vor der Wahrheit
he is afraid to tell the truth	er fürchtet sich die Wahrheit zu sagen
he is always kind	er ist immer freundlich
he is called John	er heißt Johann
he is out of practice	er ist aus der Übung
held	hielt
he lives alone	er wohnt allein
hell	Hölle
hello !	Guten Tag !
he looks after the child	er kümmert sich um das Kind
helper	Helfer
helpful	hilfreich
help	Hilfe
helpless	hilflos
help yourself	bedienen Sie sich
he missed his breakfast	er vermisste sein Frühstück
hen	Henne
here and there	hier und dort
here	hierher
here you are !	Hier bitte !
hero	Held
her	sie
hers	ihrer
hesitate	zögern
hesitation	Zögern
he washes himself	er wäscht sich
he was named after his father	er wurde nach seinem Vater benannt
hidden	versteckt
hide (irr.)	verstecken
hid	versteckte
high and low tide	Flut und Ebbe
high	hoch
highland	Hochland
highway	Fernstraße
hike	wandern
hill	Hügel
hillside	Hang
hilly	hügelig
him	ihn
hinder	behindern
hindrance	Behinderung
hire	mieten
his exact words	genau seine Worte
his generous nature	sein großzügiges Wesen
his	sein
his son is a great trouble to him	sein Sohn macht ihm Sorgen
his time is up	sein Zeit ist abgelaufen
hobby	Steckenpferd
holder	Inhaber
hold (irr.)	halten
hole	Loch
holidays	Ferien(Br.)
holiday	Urlaub
holiness	Heiligkeit
hollow	hohl
hollow out	aushöhlen
holy	heilig
homeless	heimatlos
home-made	hausgemacht
home	nachhause
homework	Hausaufgaben
honest	ehrlich
honestly	auf ehrliche Weise
honesty	Ehre
honey	Honig
honour	ehren
hook	Haken
hopeful	hoffnungsvoll
hope	Hoffnung
hopeless	hoffnungslos
horizon	Horizont
horizontal	horizontal
horn	Horn
horror	Schrecken
horse	Pferd
horse race	Pferderennen
horseshoe	Hufeisen
hospital	Krankenhaus
hostess	Hostess
host	Gastgeber
hotel	Hotel
hot-head	Hitzkopf
hot	heiß
hour-hand	Stundenzeiger
hourly	stündlich
hour	Stunde
house	Haus
household	Haushalt
house-shoes	Hausschuhe
house-wife	Hausfrau
however	jedoch
how	wie (Fragewort)
human	menschlich
humble	bescheiden
humbleness	Bescheidenheit
humbly	in bescheidener Weise
humorous	humorvoll
hundred	hundert
hundredth	hundertste
Hungary	Ungarn
hunger	Hunger
hung	hing
hungry	hungrig
hunter	Jäger
hunt	jagen
hurry	eilen
hurt (irr.)	weh tun
hurt	verletzte
I am sorry	es tut mir leid
I am worried about	ich bin besorgt wegen
I beg your pardon	ich habe nicht verstanden
ice-breaker	Eisbrecher
ice cream	Speiseeis
ice	Eis
icy	eisig
idea	Idee
ideal	Ideal
idle	müßig
idleness	Müßiggang
I don't care	ich mache mir nichts daraus
I enclose a cheque with this	ich füge einen Scheck bei
if it's raining	falls es regnet
if	ob
I have seen it already	ich habe es schon gesehen
I	ich
I know that	ich weiß dass
ill	krank
illness	Krankheit
imaginary	imaginär
imagination	Phantasie
imaginative	phantasievoll
imagine	sich vorstellen
imitate	nachahmen
imitation	Nachahmung
immediately	sofort
immediate	unmittelbar
immense	ungeheuer groß
immorality	Unmoral
immoral	unmoralisch
importance	Wichtigkeit
important	wichtig
import	importieren
impossibility	Unmöglichkeit
impossible	unmöglich
impress	beeindrucken
impression	Eindruck
imprison	Gefangen setzen
improved	verbessert
improve	verbessern
impure	unrein
impurity	Unreinheit
in an instant	in einem Moment
in any case	in jedem Fall
in case it rains	falls es regnet
in cash	bar
in chains	in Ketten
inch	Zoll
included	inbegriffen
include	umfassen
inclusive	einschließlich
income and expense	Einkommen und Ausgaben
income	Einkommen
income tax	Einkommensteuer
inconvenience	Unannehmlichkeit
inconvenient	unangenehm
incorrect	nicht richtig
increase	zunehmen
indeed	tatsächlich
independence	Unabhängigkeit
independently	in unabhängiger Weise
independent	unabhängig
India	Indien
Indian	Inder
individual	individuell
indoor	im Gebäude
indoors	im Hause
in due course	zur rechten Zeit
industrial	industriell
industry	Industrie
in earnest	im Ernst
in fact	in der Tat
in favour of	zu Gunsten von
influence	Einfluss
influential	einflussreich
information	Information
inform	informieren
in front of the building	vor dem Gebäude
in front	vorn
in	in
injure	verletzen
injury	Verletzung
ink	Tinte
in love	verliebt
in my day	zu meiner Zeit
in my view	meiner Ansicht nach
inner	innerer
inn	Gasthaus
in order to	um zu
in particular	besonders
in part	teilweise
in plain dress	in einfacher Kleidung
in possession of	im Besitz von
in print	im Druck
inquire	sich erkundigen
inquiry	Erkundigung
in safekeeping	zur sicheren Aufbewahrung
insect	Insekt
inside	Innenseite
insist on	bestehen auf
in some way or other	auf die eine oder andere Weise
in spite of	trotz
instantly	sogleich
instead of	statt
instead	stattdessen
instrument	Instrument
insult	Beleidigung
insurance	Versicherung
insured person	versicherte Person
insurer	Versicherer
insure	versichern
intelligence	Intelligenz
intelligent	intelligent
intend	beabsichtigen
intention	Absicht
interdependent	voneinander abhängig
interesting	interessant
interest	Zinsen
interference	Einmischung
interfere	sich einmischen
international	international
interpreter	Dolmetscher
interruption	Unterbrechung
interrupt	unterbrechen
interview	Interview
in that case	in diesem Fall
in the end	schließlich
in the exercise of his duties	in Ausübung seiner Pflichten
in the meantime	in der Zwischenzeit
in the midst of life	in der Mitte des Lebens
in the night	während der Nacht
in time	rechtzeitig
into	in (acc.)
into the bargain	dazu noch
into the garden	in den Garten
introduce	vorstellen
introduction	Vorstellung
in vain	vergeblich
invent	erfinden
invention	Erfindung
inventor	Erfinder
invitation	Einladung
invite	einladen
inviting	einladend
in want of	mangels an
inward	einwärts
inwards	einwärts
Ireland	Irland
Irish	irisch
Irishman (irr.)	Ire
Irish (pl.)	Iren
Irishwoman	Irin
iron	Eisen
iron-ore	Eisenerz
irregularity	Unregelmäßigkeit
irregular	unregelmäßig
I see	ich verstehe
is	ist
island	Insel
issue	herausbringen
is there anybody	ist da jemand
Italian	italienisch
Italy	Italien
it does not concern me	es betrifft mich nicht
it does not matter	es macht nichts
it	es
it escaped me	es ist mir entfallen
it failed to effect a cure	es bewirkte keine Heilung
it is a fact that	es ist eine Tatsache dass
it is in fashion	es ist in Mode
it is just ready	es ist gerade fertig
it is time to end the discussion	es ist Zeit die Diskussion zu beenden
it is wrong to steal	es ist unrecht zu stehlen
it produced an effect	es zeigte eine Wirkung
it's on your way	es liegt auf deinem Weg
it works	es geht
I've got an idea	mir ist etwas eingefallen
I was present	ich war anwesend
I will see you to the door	ich begleite dich zur Tür
I wonder if	ich frage mich ob
I wonder that	ich wundere mich dass
I won't trouble you again	ich werde Sie nicht mehr stören
jacket	Jackett
jam	Marmelade
January	Januar
Japanese	japanisch
Japan	Japan
jaw	Rachen
jealous	eiferssüchtig
jealousy	Eifersucht
jet plane	Düsenflugzeug
jet	scharfer Strahl
jewel	Juwel
job	Tätigkeit
joint action	gemeinsame Handlung
jointly	zusammenwirkend
joint	Verbindung
joke	scherzen
journey	Reise
joy	Freude
joyful	freudig
judge	urteilen
judgment	Urteil
juice	Saft
juicy	saftig
July	Juli
jump	springen
June	Juni
just	gerecht
justice	Gerechtigkeit
just what I need	gerade was ich brauche
keen	scharf
keep a promise	ein Versprechen halten
keep a secret	ein Geheimnis bewahren
keep a servant	einen Dienstboten halten
keep company	Gesellschaft leisten
keeper	Wärter
keep friendly	freundlich bleiben
keep house	den Haushalt führen
keep (irr.)	behalten
keep off the grass	Rasen nicht betreten
keep on trying	versuche es immer wieder
keep somebody waiting	jemanden warten lassen
keep up	aufrechterhalten
keep watch	halte Ausschau
keep yourself clean	halte dich sauber
kept	behielt
kettle	Kessel
keyboard	Tastatur
key	Schlüssel
kick	Tritt
kid	Zicklein
kill	töten
kilogram	Kilogramm
kilo	Kilo
kilometer	Kilometer
kind	Beschaffenheit
kingdom	Königreich
king	König
kiss	küssen
kitchen	Küche
knee	Knie
kneel (irr.)	knien
knelt	kniete
knew	wusste
knife (irr.)	Messer
knight	Ritter
knit (irr.)	stricken
knit	strickte
knives	Messer (pl.)
knock down	niederschlagen
knock	Klopfen
knot	knoten
know (irr.)	wissen
knowledge	Wissen
labour	Arbeit (Anstrengung)
labour exchange	Arbeitsvermittlung
lacking	fehlend
lack	Mangel
ladder	Leiter
lady	Dame
laid	legte
lain	gelegen (perf.)
lake	der See
lamb	Lamm
lame	lahm
lamp	Lampe
landing	Landung
land	landen
landlord	Hausherr
language	Sprache
largely	weitgehend
large	umfangreich
last	zuletzt
lately	in der letzten Zeit
later on	später
latest	neuester
late	zu spät
latter	letzterer
laughable	lächerlich
laugh	Lachen
laughter	Gelächter
laundry	Wäscherei
lavatory	Toilette
lawful	rechtmäßig
lawless	gesetzlos
law	Recht
lawyer	Jurist
lay (irr.)	legen
lay	lag
lazy	träge
lead	Blei
leader	Leitartikel
leading	führend
lead (irr.)	führen
leaf (irr.)	Blatt
leafless	blattlos
leaflet	Handzettel
leaning	Neigung
lean (irr.)	sich neigen
lean	mager
leant	lehnte an
learn by experience	aus Erfahrung lernen
learned	gelehrt (adj.)
learn (irr.)	lernen
learnt	lernte
least	geringster
leather	Leder
leave behind	zurücklassen
leave for	abreisen nach
leave (iir.)	verlassen
leave (irr.)	zurücklassen
leave me alone	laß mich allein
leave off	weglassen
leave out	auslassen
leaves	Blätter
leave the work to me	überlasse mir die Arbeit
leave	Urlaub (Militär)
led	geführt
left-handed	linkshändig
left over	übrig gelassen
left	verließ
legal expenses	Gerichtskosten
leg	Bein
leisure	Muße
lemon	Zitrone
lend (irr.)	verleihen
length	Länge
lent	lieh aus
lessening	Minderung
lessen	vermindern
lesson	Unterrichtsstunde
less	weniger
let a house	ein Haus vermieten
let fall	fallen lassen
let fly	fliegen lassen
let in	hereinlassen
let (irr.)	lassen
let	ließ
let out	preisgeben
letterbox	Briefkasten
letter	Buchstabe
letter-post	Briefpost
lettuce	Kopfsalat
level	Niveau
liberty	Freiheit
librarian	Bibliothekar
library	Bibliothek
lid	Lid
lie (irr.)	liegen
lie	lügen
life-boat	Rettungsboot
life	Leben
lifeless	leblos
life-size	in Lebensgröße
lift	hochheben
light a fire	ein Feuer anzünden
lighter	Feuerzeug
light gray	hellgrau
light-hearted	leichten Herzens
light-house	Leuchtturm
lighting	Beleuchtung
light (irr.)	anzünden
light	Licht
lightning	Blitz
likely	wahrscheinlich
like	mögen
limb	Glied des Körpers
limitation	Begrenzung
limited company	Gesellschaft mit beschränkter Haftung
limit	Grenze
line	Zeile
link	verknüpfen
lion	Löwe
lip	Lippe
lipstick	Lippenstift
liquid	Flüssigkeit
listener	Hörer
listen (to)	zuhören
list	Liste
literary	literarisch
literature	Literatur
little more than	wenig mehr als
little	wenig
lit	zündete an
live fish	lebender Fisch
lives	Leben (pl.)
live	wohnen
living	Lebensunterhalt
living room	Wohnzimmer
load	Last
loan	Darlehen
local call	Ortsgespräch
locally	örtlich
local	örtlich
lock	Türschloß
lodging(s)	Unterkunft
log of wood	Holzscheit
loneliness	Einsamkeit
lonely	einsam
long-desired	lang-begehrt
long-distance call	Ferngespräch
long-drink	Longdrink
long for	sich sehnen nach
long	lange
long-suffering	lange leidend
look after	sich kümmern um (betreuen)
look ahead	schau voraus
look at	ansehen (verb)
look before you leap	schau ehe du springst
look for	suchen
look here !	schau her !
look him in the face	schau ihm ins Gesicht
looking-glass	Spiegel
look out	Ausschau halten
look-out	Aussichtspunkt
looks	Aussehen
look	schauen
look up	nachschlagen
look well	gut aussehen
loose	lose
loosely	lose
loosen	lösen
Lord	Herrgott
Lordship	Lordschaft
lorry	Lastkraftwagen
lose	verlieren
loss	Verlust
lost	verloren
loud	laut
lovable	liebenswert
love affair	Liebesangelegenheit
love	lieben
lovely	reizend
lover	Liebhaber
lower	senken
low	niedrig
low tide	Ebbe
loyal	treu
loyalty	Treue
luck	glücklicher Zufall
lucky	glücklich
luggage	Gepäck(Br.)
lunch	Mittagessen
machine	Maschine
machinery	Maschinenanlage
madam	gnädige Frau
made	machte
mad-house	Irrenhaus
madness	Verrücktheit
mad	wütend
magazine	Zeitschrift
mailman (irr.)	Briefträger(US)
mail	Post
mail-train	Postzug
main	Haupt...
mainland	Hauptland
mainly	hauptsächlich
main road	Hauptstraße
maintain	aufrechterhalten
maize	Mais(Br.)
majority	Mehrheit
make a bed	Bett machen
make a fire	Feuer machen
make a friend	eine Freundschaft schließen
make an effort	strenge dich an
make an exception	eine Ausnahme machen
make a profit	Gewinn machen
make a promise	ein Versprechen geben
make a sudden turn	sich plötzlich wenden
make difficulties	Schwierigkeiten machen
make (irr.)	veranlassen
make it ready	fertigstellen
make over	vermachen
make room	PLatz machen
make-up	Makeup
make way	Platz machen
male	männliche Person
managed	geleitet
manage	leiten
management	Verwaltung
manager	Manager
man (irr.)	Mensch
mankind	Menschheit
manner	Art und Weise
manners	Manieren
manufacture	Herstellung
manufacturer	Hersteller
many a	mancher
many people	viele Leute
many thanks !	vielen Dank !
many	viele
map	Landkarte
march	marschieren
March	März
market	Markt
market place	Marktplatz
mark	Zeichen
marriage	Ehe
married	verheiratet
marry	heiraten
mass	Masse
mass-meeting	Großversammlung
mass-production	Massenproduktion
masterful	meisterhaft
master	meistern
masterpiece	Meisterstück
mastery	Meisterung
matches	Zündhölzer
match	zusammenpassen
material	Stoff
mat	Matte
matter	Angelegenheit
maybe	vielleicht
may	könnt
May	Mai
meadow	Wiese
meal	Mahl
meaning	Bedeutung
mean (irr.)	meinen
means	Mittel
meant	meinte
meanwhile	mittlerweile
measurable	meßbar
measurement	Maß
measure	messen
meat	Fleisch
mechanical engineering	Maschinenbau
mechanically	auf mechanische Weise
mechanic	Mechaniker
mechanics	Mechanik
medical	medizinisch
medicine	Medizin
meeting	Versammlung
meet (irr.)	treffen
meet with (irr.)	sich treffen
melting	schmelzend
melt	schmelzen
member	Mitglied
membership	Mitgliedschaft
me	mir
memorize	sich ins Gedächtnis einprägen
memory	Gedächtnis
mend a road	eine Straße ausbessern
mend	ausbessern
men	Menschen
mention	Erwähnung
menu	Speisekarte
merchant	Händler
merciful	gnädig
merciless	ungnädig
mercy	Erbarmen
merely	nur
merrily	in fröhlicher Weise
merry	fröhlich
message	Botschaft
messenger	Bote
metal	Metall
meter	Meter
met	traf
mice	Mäuse
midday	Mittag
middle-aged	mittleren Alters
middle age	mittleres Lebensalter
middle-class	Mittelstand
middle	mittlerer
midnight	Mitternacht
might	könntet
mildly	in milder Weise
mild	mild
mildness	Milde
mile	Meile
military discipline	militärische Disziplin
military	militärisch
milkmaid	Milchmädchen
milkman	Milchmann
milk	Milch
milky	milchig
miller	Müller
million	Million
millionth	millionste
mill	Mühle
mill-stone	Mühlstein
mind	Verstand
mine	meiner
mineral	mineralisch
mineral water	Mineralwasser
miner	Bergmann
minister	Minister
minute	Minute
mirror	Spiegel
misapply	falsch anwenden
miscalculate	falsch kalkulieren
miserable	elend (adj.)
misfortune	Unglück
misinformed	falsch informiert
miss a train	einen Zug versäumen
Miss	Fräulein
miss	versäumen
mistake	Fehler
mistake for something else	für etwas anderes halten
mistaken for	irrtümlich gehalten für
mist	Dunst
Mister	Herr (als Anrede)
mistook for	hielt irrtümlich für
mistress	Herrin
mistrust	Misstrauen
mixed	gemischt
mix	mischen
mixture	Mischung
mix up	durcheinander bringen
model	Vorbild
moderately	in mäßiger Weise
moderate	mäßig
moderation	Mäßigung
modernize	modernisieren
modern	modern
moment	Augenblick
Monday	Montag
money exchange	Geldwechsel
money	Geld
money-making	Geldverdienen
monkey	Affe
monthly	monatlich
month	Monat
monument	Denkmal
mood	Stimmung
moon	Mond
moral	moralisch
more	mehr
moreover	überdies
more than	mehr als
morning	Morgen
most difficult	äußerst schwierig
mostly	meistens
most	meiste
most of all	vor allem
mother-in-law	Schwiegermutter
motherly	mütterlich
mother	Mutter
mother-tongue	Muttersprache
motion	Bewegung
motorcycle	Motorrad
motor	Motor
mountain	Berg
mountainous	gebirgig
mouse (irr.)	Maus
mouse-trap	Mausefalle
mouth	Mund
mouthpiece	Mundstück
movement	Bewegung
move	sich bewegen
movies	Kino
much bigger	viel größer
much more	viel mehr
much obliged	zu Dank verpflichtet
much	viel
muddy	schlammig
mud	Schlamm
multiplication	Multiplikation
multiply	multiplizieren
murder	Mord
muscle	Muskel
museum	Museum
musical instruments	Musikinstrumente
musical	musikalisch
musician	Musiker
music	Musik
must	muss
must not	dürft nicht
mutton	Hammelfleisch
my best clothes	meine besten Kleider
my duty to my country	meine Pflicht gegenüber meinem Land
my elder brother	mein älterer Bruder
my equals	meinesgleichen
my experiences in Africa	meine Erfahrungen in Afrika
my	meiner
my private possessions	mein privater Besitz
myself	mich (rückbezogen)
my shoe pinches me	mein Schuh drückt mich
nail	Nagel
named	genannt
nameless	namenlos
namely	nämlich
name	Name
name plate	Namensschild
narrow escape	knappes Entkommen
narrowness	Enge
narrow	schmal
national	staatlich
nation	Nation
native	Einheimischer
native speaker	Muttersprachler
naturally	auf natürliche Weise
natural	natürlich
natural science	Naturwissenschaft
nature	Natur
nearly	beinahe
near	nahe
neatness	Zierlichkeit
neat	ordentlich
necessarily	notwendigerweise
necessary	notwendig
necessity	Notwendigkeit
neck	Hals
necklace	Halskette
necktie	Halstuch
needle	Nähnadel
need	Not
needy	bedürftig
neglect	Vernachlässigung
neighbourhood	Nachbarschaft
neighbouring	benachbart
neighbour	Nachbarin
neither ... nor	weder ... noch
nephew	Neffe
nerve	Nerv
nervous	nervös
nervousness	Nervösität
nest	Nest
Netherlands	Niederlande
net	Netz
network	Netzwerk
never mind !	macht nichts !
never	nie
new	neu
new potatoes	neue Kartoffeln
news from abroad	Nachrichten vom Ausland
news	Nachrichten
newspaper	Zeitung
New Year	Neujahr
New Year's day	Neujahrstag
next house	nächstes Haus
next Monday	kommenden Montag
next	nächster
nice	hübsch
nice-looking	gut aussehend
nicely	auf nette Weise
niece	Nichte
night	Nacht
nine	neun
nine o'clock	neun Uhr
nineteen	neunzehn
nineteenth	neunzehnte
ninetieth	neunzigste
ninety	neunzig
ninth	neunte
nobility	Adel
noble deed	edle Tat
noble deeds	edle Taten
noble	edel
nobleman	Edelmann
nobleness	Edelmut
nobody	niemand
no doubt	ohne Zweifel
no excuse	keine Entschuldigung
noise	Lärm
noisy	laut (adj.)
no	nein
none	keiner
nonsense	Unsinn
non-stop	ohne Aufenthalt
no one else	sonst keiner
no one	keiner
noon	Mittag
nor	auch nicht
normal	normal
northern	nördlich
north	Norden
Norway	Norwegen
nose	Nase
no such thing	keine solche Sache
not a	kein(e)
not as	nicht so wie
not at all	überhaupt nicht
notebook	Notizbuch
note	Notiz
notepaper	Notizpapier
not even	nicht einmal
nothing	nichts
noticeable	bemerkenswert
notice	bemerken
notice board	Anschlagtafel
not	nicht
not only but also	nicht nur sondern auch
not so ... as	nicht so wie
not yet	noch nicht
novel	Roman
November	November
nowadays	heutzutage
nowhere	nirgends
now	nun
nuisance	Ärgernis
number	Zahl
nurse	Krankenschwester
nursery	Kindertagesstätte
oak	Eiche
oar	Ruder
obedience	Gehorsam
obedient	gehorsam
obey	gehorchen
object	Gegenstand
objectionable	nicht einwandfrei
objection	Einwand
oblige	verpflichten
observation	Beobachtung
observe	beobachten
obtain	sich erwerben
obviously	offensichtlich
occasionally	gelegentlich
occasion	Gelegenheit
occupation	Tätigkeit
occupied with	beschäftigt mit
occupy	in Besitz nehmen
ocean	Ozean
October	Oktober
odd	komisch
of course	selbstverständlich
of equal rank	gleichrangig
off duty	außer Dienst
offence	Vergehen
offend against	verstoßen gegen
offend	beleidigen
offer	Angebot
office	Büro
office hours	Dienststunden
officer	Offizier
official	offiziell
off	weg von
often	oft
of	von
oil	Öl
old age	Greisenalter
old	alt
old books	alte Bücher
older	älter
oldest	älteste
old-fashioned	altmodisch
omit a word	ein Wort auslassen
omit	versäumen
on account of	wegen
on board	an Deck
once again	nochmal
once	einmal
on duty	im Dienst
on each side	auf beiden Seiten
one another	einander
on either side	auf beiden Seiten
one-legged	einbeinig
one	man
oneself	sich
one-sided	einseitig
on hire	zu vermieten
only boys	nur Knaben
only	nur
on purpose	absichtlich
on the wall	an der Wand
on time	pünktlich
on top	obenauf
on top of	zu oberst auf
on trial	auf Probe
on	weiter
open an account	ein Konto eröffnen
opening	Eröffnung
open	sich öffnen
operate a machine	eine Maschine bedienen
operation	Operation
opinion	Meinung
opportunity	Gelegenheit
oppose	sich widersetzen
opposite	gegenüber
orange	Orange
order	Ordnung
ordinary	gewöhnlich
or else	anderenfalls
organization	Organisation
organized	organisiert
organize	organisieren
organ	Organ
originality	Originalität
originally	ursprünglich (adv.)
original	ursprünglich
origin	Ursprung
ornament	Verzierung
or	oder
other	anderer
otherwise	sonst
ought to	solltet
ounce	Unze
our common interests	unsere gemeinsamen Interessen
ourselves	uns (rückbez.)
ours	unserer
our	unsere
outbreak	Ausbruch
outcry	Ausruf
outdoor	außerhalb des Gebäudes
outdoors	draußen im Freien
outer	äußerer
outermost	äußerster
outgoing	ausgehend
out	hinaus
outlet	Auslaß
outline	Umriß
out of	aus (heraus)
out of date	überholt
out of reach	nicht zu erreichen
out of the way	abseits vom Wege
output	Ausstoß
outside	Außenseite
outskirts	Außenbezirke
outstanding	ausstehend
overcame	überwand
over-careful	übersorgfältig
overcoat	Mantel
overcome (irr.)	überwinden
overcome	überwunden
overfeed	überfüttern
overflow	überfließen
over	vorüber
owe	schulden
owing to	wegen
owner	Besitzer
ownership	Eigentumsrecht
pace	Schritt
package	Packung
pack	packen
padded	gepolstert
padding	Wattierung
pad	Polster
page	Buchseite
paid	zahlte
painful	schmerzhaft
pain	Schmerz
paint-brush	Malerpinsel
painter	Maler
paint	malen
pair of shoes	Paar Schuhe
pale	blass
paleness	Blässe
pan	Topf
pants	Hose(US)
paper	Papier
parcel	Paket
pardon	Verzeihung
pardon ?	wie bitte ?
parental	elterlich
parents	Eltern
parents-in-law	Schwiegereltern
park	parken
parliament	Parlament
partial	zum Teil
particle	Teilchen
particular	besonderer
particularly	insbesondere
partly	teilweise
partner	Partner
part	Teil
party	Party
passage	Überfahrt
pass by	vorbeifahren
passenger	Passagier
passing by	vorübergehend
passion	Leidenschaft
pass	vorbeigehen
paste	Paste
past five	nach fünf Uhr
pastry	Gebäck
past	Vergangenheit
path	Weg
patience	Geduld
patiently	in geduldiger Weise
patient	Patient
patriotic	patriotisch
pattern	Schnittmuster
pause	pausieren
paw	Pfote
pay attention (to)	aufpassen (auf)
pay down	zahle an
paying-cards	Spielkarten
pay (irr.)	zahlen
pay me my wages	zahle mir meinen Lohn
payment	Zahlung
peace and quiet	Friede und Ruhe
peace	Frieden
peaceful	friedlich
pea	Erbse
pear	Birne (Obst)
pearl	Perle
peculiar	eigenartig
peculiarity	Eigenart
peculiarly	auf eigenartige Weise
pedestrian crossing	Fußgängerüberweg
pedestrian	Fußgänger
pence	Pence (Betrag)
pencil	Bleistift
pen	Feder (zum Schreiben)
pennies	Pennies (Münzen)
penny (irr.)	Penny
people come and go	Leute kommen und gehen
people	Volk
pepper	Pfeffer
perfection	Vollkommenheit
perfect	vollkommen
performance	Theatervorstellung
perform	aufführen
perhaps	vielleicht
period	Zeitraum
permanent	dauernd
permanently	andauernd
perm	Dauerwelle
permission	Erlaubnis
permit	erlauben
per	pro
personal	persönlich
person	Person
persuade	überreden
persuasion	Überredung
pet	Kuscheltier
petrol	Benzin(Br.)
petrol station	Tankstelle(Br.)
phone	Telefon
photo	Foto
photographer	Fotograf
photograph	fotografieren
photographic	fotografisch
photography	Fotografie (Tätigkeit)
physical	körperlich
physician	Arzt
piano	Klavier
pick	pflücken
pick-pocket	Taschendieb
pick up	vom Boden aufheben
picture	Bild
piece	Stück
piece-work	Stückarbeit
pie	Pastete
pigeon	Taube
pig	Schwein
piled up	angehäuft
pile	Haufen
pile up	aufhäufen
pillar	Säule
pillow	Kopfkissen
pinch	zwicken
pink	rosa
pin	Stecknadel
pint	etwas mehr als ein halber Liter
pipe	Tabakpfeife
pitiful	mitleidig
pity	Mitleid haben mit
place	plazieren
plain	klar
plane	Flugzeug
planet	Planet
plan	planen
planter	Pflanzer
plant	pflanzen
plastic	plastisch
plate	Teller
platform	Bahnsteig
player	Spieler
playground	Spielplatz
play	Theaterstück
plaything	Spielzeug
pleasant	angenehm
please	erfreuen
pleasure	Freude
plentiful	reichlich
plenty of food	viel zu essen
plenty of money	viel Geld
plenty of	sehr viel
plough	pflügen
pocket comb	Taschenkamm
pocket	Tasche am Anzug
poem	Gedicht
poet	Dichter
poetry	Gedichte
point at something	auf etwas deuten
pointed	spitz
point of a needle	Nadelspitze
point of view	Standpunkt
point out	hinweisen auf
point	Spitze
point to	hindeuten auf
poisoned	vergiftet
poisonous	giftig
poison	vergiften
Poland	Polen
pole	Pol
policeman (irr.)	Polizist
policemen	Polizisten
police	Polizei
police station	Polizeiwache
polish	Politur
polite	höflich
politely	auf höfliche Weise
politeness	Höflichkeit
political	politisch
politician	Politiker
politics	Politik
pool	Teich
poor	arm
popularity	Beliebtheit
popular	populär
populate	bevölkern
population	Bevölkerung
pork	Schweinefleisch
porter	Gepäckträger
Portugal	Portugal
position	Lage
possess	besitzen
possession	Besitz
possibility	Möglichkeit
possible	möglich
postage	Porto
postage stamp	Briefmarke
post a letter	einen Brief einwerfen
postcard	Postkarte
poster	Poster
postman	Briefträger
postmaster	Leiter des Postamts
post office	Postamt
post	Posten
potato	Kartoffel
pot	Topf
poultry	Geflügel
pound	Pfund
pour	gießen
poverty	Armut
powder	Pulver
powdery	puderig
powerful	mächtig
power	Macht
practically everybody	praktisch jedermann
practical	praktisch
practice	Übung
praise	loben
pray	beten
prayer-book	Gebetsbuch
prayer	Gebet
preacher	Prediger
precious	wertvoll
prefer	vorziehen
preparation	Zubereitung
prepare a meal	eine Mahlzeit zubereiten
prepare	zubereiten
presence	Anwesenheit
present	gegenwärtig
preservation	Erhaltung
preserve	bewahren
preserves	Eingemachtes
president	Präsident
press-cuttings	Zeitungsausschnitte
press	Presse
press the button	den Knopf drücken
pressure	Druck
pretence	Vorwand
pretend	vorgeben
prettiness	Niedlichkeit
pretty	hübsch
prevention	Verhinderung
preventive measures	verhütende Maßnahmen
preventive	verhindernd
prevent	verhindern
price	Preis
prick	stechen
pride	Stolz
priest	Priester
prince	Prinz
princess	Prinzessin
printed papers	Drucksachen
printer	Drucker
print	Foto
printing press	Maschine zum Drucken
prisoner	Gefangener
prison	Gefängnis
private affair	Privatangelegenheit
private	pivat
prize	Preis als Gewinn im Wettbewerb
probable	wahrscheinlich
probably	wahrscheinlich (adv.)
procession	Prozession
process	Verfahren
produce	Erzeugnis
production	Produktion
product	Produkt
professional	berufsmäßig
profession	Beruf
profit	Profit
programme	Programm (Br.)
program	Programm (Am.)
progress	Fortschritt machen
promise	Versprechen
promptly	prompt (adv.)
prompt	prompt
pronounce	aussprechen
pronunciation	Aussprache
proof	Beweis
properly	in richtiger Art und Weise
proper	richtig
property	Eigentum
proposal	Vorschlag
propose	vorschlagen
protection	Schutz
protect	schützen
protest	protestieren
proudly	stolz (adv.)
proud	stolz
prove	sich erweisen als
provide for one's children	für seine Kinder vorsorgen
provide	vorsorgen
provisions	Vorräte
pub	Kneipe
public	Öffentlichkeit
pullover, sweater	Pullover
pull	ziehen
pump	Pumpe
punctuality	Pünktlichkeit
punctually	pünktlich (adv.)
punctual	pünktlich
punish	bestrafen
punishment	Strafe
pupil	Schülerin
purchase	einkaufen
pure	rein
purity	Reinheit
purpose	Zweck
purse	Täschchen
pushing	unternehmend
push	stoßen
put an end	ein Ende machen
put a question to somebody	eine Frage stellen
put aside	beiseite stellen
put him to bed	ihn ins Bett bringen
put (irr.)	stellen
put it down	stelle es ab
put money aside	Geld beiseite legen
put on a dress	ein Kleid anziehen
put on a hat	einen Hut aufsetzen
put	setzte
puzzle	verwirren
qualification	Qualifikation
qualify	sich qualifizieren
quality	Qualität
quantity	Menge
quarrelsome	streitsüchtig
quarrel	Streit
quarterly	vierteljährlich
quarter	Viertelstunde
queen	Königin
question	Frage
queue	Schlange wartender Leute
quickly	in schneller Weise
quickness	Schnelligkeit
quick	schnell
quiet colours	ruhige Farben
quietly	in ruhiger Weise
quiet	ruhig
quite	ganz (adv.)
rabbit	Kaninchen
race horse	Rennpferd
race	Rennen
radio	Radio
radio set	Radiogerät
radio station	Rundfunkstation
railing	Reeling
railroad (Am.)	Eisenbahn
rail	Schiene
railway (Br.)	Eisenbahn
railway rates	Eisenbahntarif
rainbow	Regenbogen
rainfall	Niederschlag
rain	regnen
rainwater	Regenwasser
rainy	regnerisch
raise	hoch heben
rake	Rechen
rake up the leaves	die Blätter zusammenrechen
rang	läutete
rank	militärischer Rang
ran	rannte
rapidly developing	sich schnell entwickelnd
rapidly	in schneller Weise
rapid	schnell
rarely	selten
rare	selten
rates	Grundsteuer
rate	Tarif
rather	ziemlich
rat	Ratte
raw	roh
ray	Strahl
razor	Rasierer
reach	reichen
reader	Leser
read (irr.)	lesen
read	las
read to	vorlesen
ready	fertig
ready-made	Fertigware
real	echt
reality	Wirklichkeit
realize	verwirklichen
really	wirklich
reasonable	vernünftig
reasonably	vernünftig (adv.)
reason	Vernunft
receipt	Quittung
receive	erhalten
receiver	Empfänger
recent events	jüngste Ereignisse
recent	kürzlich
recently	vor kurzem
reception	Empfang
recognition	Anerkennung
recognize	erkennen
recommendation	Empfehlung
recommend	empfehlen
recorder	Gerät zum Aufzeichnen
record player	Plattenspieler
record	Schallplatte
recover	sich erholen
Red Cross	Rotes Kreuz
redden	rot machen
reddish	rötlich
red-hot	rotglühend
red Indian	Indianer
red	rot
reduce	herabsetzen
reduction	Kürzung
referee	Schiedsrichter
reference	Referenz
referring to	mit Bezug auf
refer to	sich beziehen auf
reflection	Überlegung
reflect	reflektieren
refresh	erfrischen
refreshing	erfrischend
refreshment	Erfrischung
refrigerator	Kühlschrank
refusal	Ablehnung
refuse	verweigern
regardful	rücksichtsvoll
regardless	rücksichtslos
regard	Respekt
region	Gegend
register	Verzeichnis
regret	Bedauern
regularly	regulär (adv.)
regular petrol	Normalbenzin
regular	regelmäßig
reign	regieren (Monarch)
rejoice	sich erfreuen
related	verwandt
relation	Verwandter
relative	Verwandter
relief	Erleichterung
relieve	erleichtern
religion	Religion
religious	religiös
rely on	sich verlassen auf
remain	verbleiben
remark	sich äußern
remedy	Mittel
remember	sich erinnern an
remind	jemanden erinnern
removal	Umzug
remove	entfernen
rent	Pacht
repair	Reperatur
repeated	wiederholt
repeat	wiederholen
reply	antworten
reporter	Reporter
report	Schulzeugnis
representative	Vertreter
represent	vertreten
republic	Republik
request	Gesuch
require	erfordern
requirements	Erfordernisse
rescue	Rettung
research	Forschung
reservation	Reservierung
reserve	reservieren
resistance	Widerstand
resist	widerstehen
respectful	voll Respekt
respect	respektieren
responsible	verantwortlich
result	Ergebnis
result from	vergeben aus
result in	führen zu
resulting	resultierend
retired	pensioniert
retired person	Person im Ruhestand
retirement	Ruhestand
retire	sich zurückziehen
return ticket	Rückfahrkarte
return	zurückkehren
revenge	rächen
review	verbessern
revolution	Revolution
reward	Belohnung
ribbon	Band
rice	Reis
riches	Reichtümer
rich	reich
ridden	geritten
ride (irr.)	reiten
rider	Reiter
right angle	rechter Winkel
right	richtig
ring (irr.)	läuten
ring	Ring
ripen	reifen
ripe	reif
rise (irr.)	aufstehen
risen	aufgestanden
rising	aufsteigend
risk	riskieren
risky	riskant
rival	Rivale
rivalry	Rivalität
river-bank	Flussufer
river	Fluß
road accident	Verkehrsunfall
road	Landstraße
roadside	Straßenrand
roar	Gebrüll
roast	gebraten
rob	berauben
robber	Räuber
robbery	Raubüberfall
rocking-chair	Schaukelstuhl
rock	schaukeln
rode	ritt
rod	Rute
roller	Roller
roll	rollen
roof	Dach
rooms to let	Zimmer zu vermieten
room	Zimmer
rooted	verwurzelt
root	wurzeln
rope	Seil
rose	stand auf
rotten	verrottet
rot	verrotten
rough	grob
roughly	ungefähr
roughness	Derbheit
round	um ... herum
rowing boat	Ruderboot
row	rudern
royal	königlich
rubber	Gummi
rubber tube	Gummischlauch
rubbish	Abfall
rub	reiben
rudely	in unhöflicher Weise
rude	unhöflich
rug	Vorleger
ruin	ruinieren
ruins	Trümmer
rule	regieren
ruler	Linial
run a business	ein Geschäft leiten
run across	stoßen auf
run away	weglaufen
rung	geläutet
run into danger	Gefahr laufen
run (irr.)	rennen
run	Lauf
running	laufend
run risks	Risiken eingehen
run up and down	auf und ab rennen
rush	eilen
rush hour	Hauptverkehrszeit
Russian	russisch
Russia	Russland
sack	Sack
sacred	heilig
sacrifice	opfern
sadden	traurig machen
saddle	satteln
sadly	in trauriger Weise
sadness	Traurigkeit
sad	traurig
safe and sound	sicher und gesund
safely	in sicherer Weise
safe	sicher
safety	Sicherheit
said	sagte
sailing boat	Segelboot
sailor	Matrose
sail	segeln
salad	Salat
salary	das Gehalt
sales assistant	Verkäufer(in) (Br.)
salesclerk	Verkäufer(in) (US)
salesman	Verkäufer
sale	Verkauf
salt	Salz
sample	Muster
sandbank	Sandbank
sandhill	Sandhügel
sand	Sand
sang	sang
sank	sank
satisfaction	Befriedigung
satisfactory	zufriedenstellend
satisfy	befriedigen
sat	saß
Saturday	Samstag
saucer	Untertasse
sauce	Soße
sausage	Würstchen
save	sparen
savings	Ersparnisse
sawn	gesägt
saw	sah
say (irr.)	sagen
scale	Skala
scales	Waage
scarce	knapp
scarcely	kaum
scarcity	Knappheit
scatter	verstreuen
scene	Szene
school-book	Schulbuch
school-boy	Schuljunge
school	Schule
science	Wissenschaft
scientific	wissenschaftlich
scientist	Wissenschaftler
scissors	Schere
scold	schelten
Scotch	schottischer Whisky
Scotland	Schottland
Scotsman (irr.)	Schotte
Scots (pl.)	Schotten (pl.)
Scotswoman (irr.)	Schottin
Scottish	schottisch
scrape	schaben
scratch	Kratzer
screen	Filmleinwand
screw	schrauben
sea	die See
sea-level	Meereshöhe
seaman	Seemann
search for	suchen (nach)
searching	suchend
search	Suche
season	Saison
seat	Sitzplatz
sea-water	Meereswasser
sea waves	Meereswellen
second-hand	gebraucht
second	zweite
secrecy	Verschwiegenheit
secretary	Sekretärin
secret	Geheimnis
seed	Samen
see (irr.)	verstehen
seem	scheinen
seen	gesehen
seize	ergreifen
seldom	selten
self-control	Selbstkontrolle
self-defence	Selbstverteidigung
selfish	selbstsüchtig
self...	selbst...
self service restaurant	Selbstbedienungsrestaurant
seller	Verkäufer
sell (irr.)	verkaufen
sell out	ausverkaufen
sender	Absender
send (irr.)	schicken
sense	Sinn
sensible	vernünftig
sentence	Urteil des Gerichts
sent	schickte
separate	trennen
separation	Trennung
September	September
series	Serie
serious	ernst
servant	Diener
serve	servieren
service	Service
set (irr.)	stellen
set	setzte
settle a dispute	einen Streit beilegen
settlement	Regelung
settler	Siedler
settle	sich niederlassen
seven at one blow	sieben auf einen Schlag
seven	sieben
seventeen	siebzehn
seventeenth	siebzehnte
seventh	sieb(en)te
seventieth	siebzigste
seventy	siebzig
several	verschiedene
severely	in schlimmer Weise
severe	streng. heftig
sew (irr.)	nähen
sewn	genäht
sex	Geschlecht
shade	schattieren
shadow	Schatten
shadowy	schattig
shady	schattig
shake (irr.)	schütteln
shaken	geschüttelt
shallow	seicht
shall	werden
shameful	schändlich
shameless	schamlos
shame	Schande
shampoo and set	Waschen und Legen
shape	formen
shapeless	formlos
share	teilen
sharpen	schärfen
sharpness	Schärfe
sharp	scharf
shave	sich rasieren
shed (irr.)	vergießen
shed	vergossen
sheep (irr.)	Schaf
sheep (pl.)	Schafe
she is expecting a baby	sie erwartet ein Baby
shelf (irr.)	Regal
shelves	Regale
she	sie
she turned away	sie wandte sich ab
she washes herself	sie wäscht sich
shine (irr.)	scheinen
shine	Schein
shining	glänzend
shipbuilding	Schiffsbau
ship	verschiffen
shipwreck	Schiffswrack
shirt	Hemd
shock	schockieren
shoe-maker	Schuhmacher
shoe	Schuh
shone	schien
shook	schüttelte
shoot (irr.)	schießen
shop assistant	Verkäufer(in)
shop	Laden
shopping	Einkaufen
shop window	Schaufenster
shore	Küste
shortage	Knappheit
shorten	kürzen
short	kurz
shortness	Kürze
short-sighted	kurzsichtig
shot	Schuß
shoulder	Schulter
should	würden
shout	lauter Schrei
shower	Regenschauer
show (irr.)	zeigen
shown	gezeigt
show	Schau
shut in	einschließen
shut (irr.)	schließen
shut	schloss
shut up	verschließen
shyness	Schüchternheit
shy	schüchtern
sick	krank
sickness	Übelkeit
side	Seite
sideways	nach der Seite
sightseeing	Besichtigungen
sight	Sehvermögen
sights	Sehenswürdigkeiten
signal	signalisieren
signature	Unterschrift
signs of wear	Zeichen der Abnutzung
sign	Zeichen
silence	zum Schweigen bringen
silently	schweigend
silent	still
silk ribbons	Seidenbänder
silk	Seide
silkworm	Seidenraupe
silver chain	Silberkette
silver coins	Silbermünzen
silver	Silber
silvery	silberig
similar	ähnlich
simple	einfach
simplicity	Einfachheit
simply	in einfacher Weise
since 1980	seit 1980
sincere	aufrichtig
since	weil
singer	Sänger(in)
sing (irr.)	singen
single	einzeln
single-handed	mit einer Hand
singly	einzeln (adv.)
sink (irr.)	sinken
sin	Sünde
sir	mein Herr
sister-in-law	Schwägerin
sister	Schwester
sit down	sich (hin)setzen
sit (irr.)	sitzen
sitting room	Wohnzimmer(Br.)
situated	gelegen (Gebäude etc)
situation	Lage
six	sechs
sixteen	sechzehn
sixteenth	sechzehnte
sixth	sechste
sixtieth	sechzigste
sixty	sechzig
size	Größe
skilful	geschickt (adj.)
skilled	geschickt
skill	Geschick
skin	Haut
skirt	Rock
ski	skilaufen
sky	Himmel
slavery	Sklaverei
slave	Sklave
sleeper	schlafende Person
sleepiness	Schläfrigkeit
sleeping-car	Schlafwagen
sleep (irr.)	schlafen
sleepless	schlaflos
sleep	Schlaf
sleepy	schläfrig
sleeve	Ärmel
slept	schlief
slice	Schnitte
slide	Dia(positiv)
slide (irr.)	gleiten
slid	glitt
slight	gering(fügig)
slightly	in geringfügiger Weise
slim	schlank
slippery	schlüpfrig
slip	Unterkleid
slope	Abhang
slow down	verlangsamen
slow	langsam
slow-moving	sich langsam bewegend
slowness	Langsamkeit
small	klein
smallness	Geringfügigkeit
small packet	Päckchen
smell	Geruch
smell (irr.)	riechen
smelt	roch
smile	Lächeln
smoke	rauchen
smoker	Raucher
smooth	glätten
snack bar	Snackbar
snack	Imbiß
snake	Schlange
snow-ball	Schneeball
snow-flake	Schneeflocke
snow	schneien
snow-storm	Schneesturm
snow-white	schneeweiß
soap	Seife
soapy	seifig
so-called	sogenannt
social	gesellschaftlich
socially	gesellschaftlich (adv.)
society	Gesellschaft
sock	Socke
so do I	ich auch
sofa	Sofa
soft drinks	alkoholfreie Getränke
soften	weich machen
softness	Weichheit
soft	weich
soil	schmutzig machen
soldier	Soldat
sold	verkaufte
solemn	feierlich
solid	von fester Beschaffenheit
solution	Lösung
solve	lösen
somebody	jemand
some day	eines Tages
somehow	irgendwie
some	irgendeines
some milk	etwas Milch
some more	noch etwas
someone	jemand
something	etwas
something to eat	etwas zum Essen
sometimes	manchmal
somewhat	ein bisschen
somewhere	irgendwo
son-in-law	Schwiegersohn
son	Sohn
soon after	bald danach
soon	bald
sooner	früher
sore throat	Halsschmerzen
sore	wund
sorrowful	voll Sorge
sorrow	Sorge
sorry !	Entschuldigung !
sort	Sorte
so	so
soul	Seele
sound	Ton
soup	Suppe
source	Ursprung
sour	sauer
southeast	südöstlich
southern	südlich
south of	südlich von
south	Süden
so we are even	wir sind somit gleich
sow (irr.)	säen
sown	gesät
space	Weltraum
spade	Spaten
Spain	Spanien
Spanish	spanisch
spare part	Ersatzteil
spare	übrig haben
speak about something	über etwas sprechen
speaker	Redner
speak from experience	aus Erfahrung sprechen
speak (irr.)	sprechen
sped	geeilt
speech	Rede
speed	Geschwindigkeit
speed (irr.)	eilen
spelling	Rechtschreibung
spell (irr.)	buchstabieren
spelt	buchstabierte
spend (irr.)	ausgeben
spent	gab aus
spin (irr.)	spinnen
spinning-wheel	Spinnrad
spirit	Geist
spit	spucken
splendid	großartig
splendidly	in großartiger Weise
split (irr.)	spalten
split	Spaltung
spoil (irr.)	verwöhnen
spoilt	verwöhnte
spoken	gesprochen
spoke	sprach
sponge	Schwamm
spoon	Löffel
sports-car	Sportwagen
sportsman	Sportler
sport	Sport
sportswoman	Sportlerin
spotless	fleckenlos
spot	Ort
spotted	gefleckt
sprang	sprang
spread	breitete aus
spread butter	Butter aufstreichen
spread (irr.)	sich ausbreiten
spread its wings	seine Flügel ausbreiten
spring (irr.)	springen
spring	Quelle
spring-time	Frühlingszeit
sprung	gesprungen
spun	spann
spy	Spion
square	Quadrat
stadium	Stadion
staff	Personal
stage	Stadium
stain	Flecken
stairs	Treppe
stamp-collector	Briefmarkensammler
stamp	stempeln
stand about	herumstehen
standardization	Standardisierung
standardize	standardisieren
standard	Standard
stand for	stehen für
stand (irr.)	stehen
stand up	steh auf
stand	vertragen
star	Stern
start	starten
statement	Erklärung
state	Zustand
stationed	stationiert
station	stationieren
stay	wohnen (vorübergehend)
steady	gleichmäßig
steak	Steak
steal (irr.)	stehlen
steam	dampfen
steam-engine	Dampfmaschine
steamer	Dampfer
steel	Stahl
steel tubing	Stahlrohr
steep	steil
steer	steuern
step	Stufe
stick (irr.)	stecken
stick	Stock
sticky	klebrig
stiffen	versteifen
stiffness	Steifheit
stiff	steif
stillness	Stille
still	sich nicht bewegend
sting	Insektenstich
sting (irr.)	stechen (Insekt)
stir	umrühren
stir up	aufrühren
stockings	Strümpfe
stock	Vorrat
stolen	gestohlen
stole	stahl
stomach	Magen
stone	Stein
stony	steinig
stood	stand
stop	Haltestelle
store-keeper	Lagerverwalter
store	Vorrat
storm	stürmen
stormy	stürmisch
story	Geschichte
story-teller	Geschichtenerzähler
stove	Ofen
straightaway	geradewegs
straighten	gerade machen
straight	gerade
strange behaviour	seltsames Benehmen
strange customs	fremde Gebräuche
strangely	in seltsamer Weise
stranger	Fremder
strange	seltsam
strap	Straps
strawberry	Erdbeere
straw	Trinkhalm
stream	strömen
street	Straße
strength	Stärke
stretched out his hand	streckte seine Hand aus
stretch	Strecke
strict	strikt
strike (irr.)	schlagen
strike	Streik
string	Bindfaden
stripe	Streifen
strip	Streifen
strong	stark
struck	schlug
structure	Bauwerk
struggle	kämpfen
stuck	steckte
student	Student(in)
study	Studium
stuff	Zeug
stung	stach
stupid	dumm
stupidity	Dummheit
stupidly	in törichter Weise
style	Stil
subject	Untergebener
substance	Substanz
succeed	nachfolgen
success	Erfolg
successful	erfolgreich
successfully	in erfolgreicher Weise
successor	Nachfolger
such a	solch ein
such as	wie zum Beispiel
such	solcher
suck	saugen
suddenly	plötzlich
sufferer	Leidender
suffer	leiden
sugar	Zucker
suggestion	Vorschlag
suggest	vorschlagen
suitable	passend
suitcase	Handkoffer
suit	passen
summer	Sommer
sum	Summe
sunbeam	Sonnenstrahl
sunburnt	braun gebrannt
Sunday	Sonntag
sung	gesungen
sunk	gesunken
sunlight	Sonnenlicht
sunny	sonnig
sun rise, day break	Sonnenaufgang
sunset, dusk	Sonnenuntergang
sunshine	Sonnenschein
sun	Sonne
supermarket	Supermarkt
super	Super (Benzin)
supper	spätes Abendessen
supply	Vorrat
supply with	beliefernmit
support	Unterstützung
suppose	vermuten
surely	sicherlich
sure	sicher
surface	Oberfläche
surgeon	Chirurg
surname	Familienname
surprise	Überraschung
surprisingly	überraschenderweise
surprising	überraschend
surroundings	Umgebung
surround	umgeben
survive	überleben
suspect	verdächtigen
suspicion	Argwohn
swallow	Schwalbe
swam	schwamm
swear (irr.)	schwören
sweat	schwitzen
Sweden	Schweden
sweep (irr.)	kehren
sweeten	süßen
sweets	Süßigkeiten
sweet	süß
swell (irr.)	schwellen
swept	gefegt
swim (irr.)	schwimmen
swing	schaukeln
Swiss	Schweizer
switch	Schalter (elektrischer)
Switzerland	Schweiz
swollen	geschwollen
sword	Schwert
swore	schwor
sworn	geschworen
swum	geschwommen
sympathy	Mitgefühl
table-cloth	Tischtuch
table of contents	Inhaltsverzeichnis
table	Tisch
table-top	Tischplatte
tablet	Tablette
tailor	Schneider
tail	Schwanz
take a bath	ein Bad nehmen
take a holiday	sich frei nehmen
take away	wegnehmen
take care (of)	achtgeben (auf)
take care of	sorgen für
take care	sei vorsichtig
take (irr.)	nehmen
take leave	Urlaub nehmen
take medicine	Medizin einnehmen
taken	genommen
take notice	Notiz nehmen
take off	starten (abheben) (Flugzeug)
take on a job	eine Arbeit übernehmen
take part	teilnehmen an
take place	stattfinden
take something back	etwas zurücknehmen
take things easy	nimm es leicht
take time	sich Zeit nehmen
talk about something	von etwas reden
talk business	vom Geschäft reden
talk over	besprechen
talk	reden
tall	groß (von Wuchs)
tame	zähmen
tape recorder	Tonbandgerät
tape	Tonband
tap on the door	leicht an die Tür klopfen
tap	Wasserhahn
task	Aufgabe (gestellte)
tasteless	geschmacklos
taste	schmecken
taught	unterrichtet
taxi	Taxi
tax	Steuer
teacher	Lehrer
teach (irr.)	lehren
tea-cup	Teetasse
team	Mannschaft
tea-party	Einladung zum Tee
tea-pot	Teekanne
tear apart	auseinander reißen
tear (irr.)	zerreißen
tear to pieces	in Stücke reißen
tear	Träne
tea-spoon	Teelöffel
tea	Tee
teeth	Zähne
telegram	Telegramm
telegraph	telegrafieren
telephone call	Anruf (Telefon)
telephone	telefonieren
television	Fernsehen
television screen	Bildschirm
television set	Fernsehgerät
tell a story	eine Geschichte erzählen
tell (irr.)	sagen
tell the truth	die Wahrheit sagen
temperature	Temperatur
temper	Temperament
temple	Tempel
temptation	Versuchung
tempt	versuchen zu verführen
tendency	Tendenz
tenderly	in zärtlicher Weise
tenderness	Zärtlichkeit
tender	zärtlich
tend	tendieren
tend to	neigen zu
ten minutes to three	zehn Minuten vor drei Uhr
tennis court	Tennisplatz
tenth	zehnte
tent	Zelt
ten	zehn
terms	Bedingungen (Vertrag)
term	Semester
terrible	schrecklich
terribly	auf schreckliche Art und Weise
test	Test
textbook	Lehrbuch
text	Text
than	als (bei Steigerung)
thankful	dankbar
thanks for the trouble !	danke für die Mühe !
thanksgiving	Danksagung
thank you	danke schön
thank you very much !	vielen Dank !
that	jenes
that will do	das genügt
the answer to a question	die Antwort auf eine Frage
the art of healing	die Heilkunst
theatre	Theater
theatrical performance	Theateraufführung
the attempt failed	der Versuch ging daneben
the British Isles	die britischen Inseln
the chief events of the year	die Haupereignisse des Jahres
the colour faded	die Farbe verblaßte
the daily press	die Tageszeitungen
the day after tomorrow	übermorgen
the	die
the doctor will fix you up	der Arzt wird dich gesund machen
the earth and the moon	Erde und Mond
the English	die Engländer
the English language	die englische Sprache
the essentials of the problem	die wesentlichen Punkte des Problems
the exact time	die genaue Zeit
the fall of an apple	der Fall eines Apfels
the human race	Menschheit
their	ihre
theirs	ihres
the key to his success	der Schlüssel zu seinem Erfolg
the light faded	das Licht erlosch
the man that I saw	der Mann den ich sah
themselves	sich (3. pers. pl.)
them	sie
the music rose and fell	die Musik wurde lauter und schwächer
then	dann
the people of this town	die Leute dieser Stadt
the present	die Gegenwart
the proper place	der richtige Ort
the proper time	die richtige Zeit
the real value	der wahre Wert
there	dorthin
therefore	deshalb
there goes the bell !	jetzt klingelt es !
there is no choice	es gibt keine Wahl
there you are !	da haben wir's !
the same	die gleiche
these	diese hier (pl.)
the sooner the better	je eher desto lieber
the story amused me	die Geschichte amüsierte mich
the strangest thing yet	die bisher seltsamste Sache
the street ended in a field	die Straße endete in einem Feld
the train is not due yet	der Zug ist noch nicht fällig
the train to London	der Zug nach London
the water is boiling	das Wasser kocht
the water is freezing	das Wasser gefriert
the weather changed	das Wetter hat sich geändert
the whole amount	der ganze Betrag
the wrong day	der falsche Tag
the wrong number	die falsche Nummer
they	sie (pl.)
thick	dick
thicken	dick machen
thickness	Dicke (Stärke)
thief (irr.)	Dieb
thieves	Diebe
thin	dünn
thing	Ding
thinker	Denker
think (irr.)	denken
third	dritte
thirst	Durst
thirst for knowledge	Wissensdrang
thirsty	durstig
thirteen	dreizehn
thirteenth	dreizehnte
thirtieth	dreißigste
thirty	dreißig
this afternoon	heute nachmittag
this day	heute
this	dieser hier
this evening	heute abend
this morning	heute morgen
this time next year	um diese Zeit im nächsten Jahr
this will cheer you up	das wird dich aufmuntern
this will ease the pain	dies wird die Schmerzen lindern
this work is easy	diese Arbeit ist leicht
thoroughly	gründlich
those	jene (dort) (pl.)
though	obwohl
thoughtfulness	Zuvorkommenheit
thoughtful	rücksichtsvoll
thoughtless	gedankenlos
thoughtlessness	Gedankenlosigkeit
thought	Überlegung
thousand	tausend
thousandth	tausendste
thread	Faden
threat	Drohung
threaten	drohen
three	drei
three times	dreimal
threw	warf
throat	Kehle
through	durch
through knowledge	gründliche Kenntnisse
throughout	überall
throw away	wegwerfen
throw (irr.)	werfen
thrown	geworfen
throw	Wurf
thumb	Daumen
thunder	donnern
thunderstorm	Gewitter
Thursday	Donnerstag
thus	so (auf diese Weise)
ticket	Fahrkarte
tidal	den Gezeiten unterworfen
tide	Gezeitenströmung
tidy	sauber
tie	Kravatte
tiger	Tiger
tight	eng anliegend
till	bis
time limit	Frist
time presses	die Zeit drängt
timetable	Stundenplan
time	Zeit
tin	Konservendose (Br.)
tiny	winzig
tip	Trinkgeld
tired	müde
tire	ermüden
to and fro	hin und her
tobacco	Tabak
today has been fine	der heutige Tag war schön
today	heute
toe	Zehe
together	zusammen
toilet	Toilette
told	erzählte
tomato	Tomate
tomorrow	morgen
tongue	Zunge
tonight	heute abend
ton	Tonne
took	nahm
tool-box	Werzeugkasten
tool	Werkzeug
too (nachgestellt)	auch
toothache	Zahnweh
toothbrush	Zahnbürste
too thick	zu dick
tooth (irr.)	Zahn
toothpaste	Zahnpasta
top corner	obere Ecke
topic	Gesprächsthema
top of the mountain	Berggipfel
top of the tree	Baumspitze
top	Spitze (oberstes Ende)
tore	zerriss
torn	zerrissen
total	Gesamtsumme
to the full extent	in vollem Ausmaß
touch	Berührung
tough	zäh
tourist	Tourist
tour	Rundreise
towards	gegen
towards the end	gegen Ende
towel	Handtuch
tower	Turm
town-hall	Rathaus(Br.)
town	Stadt
toy	Spielzeug
to	zu
trace	Spur
track	Gleis
tractor	Traktor
trade	Handel
trade is very dull	das Geschäft ist sehr flau
trade mark	Warenzeichen
trader	Händler
tradesman	Gewerbetreibender
trade union	Gewerkschaft
traffic lights	Verkehrsampel
traffic	Verkehr
training	Training
train	Zug (Bahn)
tram	Straßenbahn
translate	übersetzen
translation	Übersetzung
translator	Übersetzer
transport	transportieren
trap	in einer Falle fangen
travel-agency	Reisebüro
traveler	Reisender
travel	reisen
tray	Servierbrett
tread (irr.)	treten
treasurer	Schatzmeister
treasure	Schatz
treat	behandeln
treatment	Behandlung
tree	Baum
tremble	zittern
trial	Versuch
tribe	Volksstamm
trick	Trick (Streich)
trodden	getreten
trod	trat
troop	Truppe
troubled	in Schwierigkeiten gebracht
trouble maker	Unruhestifter
troublesome	lästig
trouble	Unruhe
trousers	Hose
truck	Lastkraftwagen(US)
true	wahr
truly	aufrichtig
trunk call	Ferngespräch(Br.)
trunk of a tree	Baumstamm
trunk	Rumpf
trustful	vertrauensvoll
trust	Vertrauen
truthful	wahrhaftig
truth	Wahrheit
try on	anprobieren
try	versuchen
tube	U-Bahn (London)
Tuesday	Dienstag
tune a piano	ein Klavier stimmen
tune	Melodie
turkey	Truthahn
Turkey	Türkei
turn around	such umdrehen
turn away	sich abwenden
turning point	Wendepunkt
turning	Querstraße
turn off	ausschalten
turn off the gas	das Gas abdrehen
turn on	einschalten
turn on the gas	das Gas aufdrehen
turn-over	Umsatz
turn the page	umblättern
turn the radio off	schalte das Radio ab
turn to the right	nach rechts abbiegen
turn	Wendung
twelfth	zwölfte
twelve	zwölf
twentieth	zwanzigste
twenty-first	einundzwanzigste
twenty-one	einundzwanzig
twenty-second	zweiundzwanzigste
twenty-third	dreiundzwanzigste
twenty-two	zweiundzwanzig
twenty	zwanzig
twice	zweimal
twist	verdrehen
two days ago	vor zwei Tage
two equal parts	zwei gleiche Teile
two	zwei
type	Typ
typewriter	Schreibmaschine
typist	Schreibkraft
ugly building	hässliches Gebäude
ugly	hässlich
umbrella	Regenschirm
unarmed	unbewaffnet
unavoidable	unvermeidlich
unbounded ambition	grenzenloser Ehrgeiz
unbutton	aufknöpfen
uncertainty	Ungewissheit
uncertain	ungewiss
uncle	Onkel
uncomfortable	unbequem
uncommon	ungewöhnlich
under 10 pounds	unter zehn Pfund
underclothing	Unterwäsche
underdeveloped	unterentwickelt
undergraduate	Student
underground	U-Bahn
underline	unterstreichen
underneath	darunter
under pressure	unter Druck
undersell	unterbieten
understanding	Verständnis
understand (irr.)	verstehen
understood	verstanden
undertake (irr.)	übernehmen
undertaken	übernommen
under the control of	unter Leitung von
under the impression that	unter dem Eindruck dass
under the name of	unter dem Namen von
under these conditions	unter diesen Bedingungen
under the skin	unter die Haut
undertook	übernahm
under	unter
uneducated	ungebildet
unemployed	arbeitslos
unemployment	Arbeitslosigkeit
uneventful	ohne Ereignisse
unhappy	unglücklich
uniform	Uniform
union	Vereinigung
United States of America	Vereinigte St. von Amerika
unit	Einheit
unite	vereinigen
unit of time	Zeiteinheit
unity	Einigkeit
universal	universell
universe	Weltall
university	Universität
unkind	unfreundlich
unknown	unbekannt
unlawful	unrechtmäßig
unless	wenn nicht
unlikely	unwahrscheinlich
unlucky	unglücklich
unnecessary	unnötig
unpack	auspacken
unpaid	unbezahlt
unpleasant	unangenehm
unsatisfactory	unbefriedigend
until	bis
untrue	unrichtig
unwilling	unwillig
up	hinauf
upon	auf (prep.)
up on the hill	droben auf dem Hügel
uppermost	zuoberst
upper	oberer
upright	aufrecht
uproot	entwurzeln
upset (irr.)	umwerfen
upset stomach	verdorbener Magen
upset the boat	das Boot umkippen
upset the milk-jug	das Milchkännchen umkippen
upset	umgekippt
upside-down	umgekehrt
upstairs	oben
up the hill	den Hügel hinauf
up-to-date	modern
up to midday	bis mittags
up to seven	bis sieben
upwards	aufwärts
urge	drängen
urgency	Eile
urgent	dringend
urgently	dringend (adv.)
used goods	gebrauchte Ware
used to (do)	pflegte zu (tun)
usefulness	Nützlichkeit
useful	nützlich
useless	nutzlos
use	Nutzen
use up	aufbrauchen
usually	üblicherweise
usual	üblich
us	uns
vacation	Urlaub
valley	Tal
valuables	Wertsachen
valuable	wertvoll
value added tax	Mehrwertsteuer
valueless	wertlos
value	Wert
variety	Spielart
various opinions	verschiedene Ansichten
various	verschiedenartig
veal	Kalbfleisch
vegetable	Gemüse
vehicle	Fahrzeug
veiled	verschleiert
veil	Schleier
venison	Wild(bret)
verb	Tätigkeitswort
violin	Violine
virtue	Tugend
virtuosity	Kunstfertigkeit
virtuous	vortrefflich
visit	besuchen
visitor	Gast
voice	Stimme
volume	Volumen
vote (for)	stimmen (für)
voter	Wähler
vote	Stimme des Wählers
wages	Lohn
wagon	Wagen
waistcoat	Weste
waist	Taille
wait and see	warte ab
waiter	Kellner
waiting room	Wartezimmer
waitress	Kellnerin
wait the result	warte auf das Ergebnis
wait	warten
wake (irr.)	aufwecken
wake up	wach auf
Wales	Wales
walking-stick	Spazierstock
walk	zu Fuß gehen
wall	Wand
wander	umherwandern
want	wünschen
wardrobe	Schrank (für Kleider)
war	Krieg
warmly	in freundlicher Weise
warmth	Wärme
warm	wärmen
warning	Warnung
warn	warnen
washing machine	Waschmaschine
wash the dishes	das Geschirr spülen
wash	waschen
wastefulness	Verschwendung
wasteful	verschwenderisch
wastepaper basket	Papierkorb
waste	verschwenden
was	war
watch-dog	Wachhund
watchman	Wächter
watch	wachen
waterfall	Wasserfall
water-proof	wasserdicht
water	Wasser
wave	winken
wavy	wellig
wax	Wachs
way	Weg
weaken	schwächen
weakness	Schwäche
weak	schwach
we all	wir alle
wealth	Reichtum
wealthy	reich
weapon	Waffe
wear	Abnutzung
wear a coat	einen Mantel tragen
wear down	abnutzen
wear (irr.)	tragen
wear off	sich abnutzen
weather forecast	Wettervoraussage
weather	Wetter (das)
weaver	Weber
weave	weben
wedding	Hochzeit
Wednesday	Mittwoch
weed	Unkraut jäten
weekday	Wochentag
weekend	Wochenende
weekly	wöchentlich
week	Woche
weep (irr.)	weinen
weight	Gewicht
weigh	wiegen
welcome	willkommen heißen
well-built	gut gebaut
well-chosen	gut gewählt
well-done	gut gemacht
well dried	gut getrocknet
well-meant	gut gemeint
well-off	gut dran
well	wohlauf
went	ging
wept	weinte
were	wärst
western	westlich
West Germany	Westdeutschland
westward	westwärts
west	Westen
wet	Nässe
we	wir
what can I do for you ?	was wünschen Sie bitte ?
what day will suit you	welcher Tag paßt dir
whatever	was auch immer
what is that	was ist das
what nonsense !	was für ein Unsinn !
what's the matter ?	was ist los ?
what's the news ?	was gibt es Neues ?
what	was für ein
wheat	Weizen
wheel	Rad
whenever	wann auch immer
when	wenn (zeitlich)
wherever	wo auch immer
where	wohin
whether	ob
whichever	welcher auch immer
which	welcher (Frage)
while	Weile
whilst	während
whipped cream	Schlagsahne
whip	schlagen
whisk(e)y	Whisky
whisper	flüstern
whistle	Pfeife (Signalpfeife)
white as snow	weiß wie Schnee
whiten	weißmachen
white	weiß (Farbe)
whoever	wer auch immer
who is there ?	wer ist da ?
whole	ganzer
wholly	ganz (adv.)
whom	welchen
who(m)	wen
whose	wessen
who	wer
why	warum
wicked	gottlos
wickedly	in boshafter Weise
wickedness	Bosheit
wide-awake	hellwach
widen	ausweiten
wide-spread	weitverbreitet
wide	weit
widow	Witwe
width	Breite
wife (irr.)	Frau (Gattin)
wild	wild
willing	gewillt
willingly	gerne
will	wollt
wind (irr.)	wickeln
window	Fenster
wind	Wind
windy	windig
wine and spirits	Weine und Spirituosen
wine	Wein
wing	Flügel
win (irr.)	gewinnen
winning	gewinnend
winter	Winter
wipe	wischen
wire	Telegramm(US)
wisdom	Weisheit
wise	weise
wish	wünschen
with caution	vorsichtig
withdraw (irr.)	zurückziehen
withdrawn	abgehoben
withdrew	hob ab
within easy reach	leicht zu erreichen
within five minutes	in fünf Minuten
within	in (innerhalb von)
with	mit
without effort	ohne Mühe
without money	ohne Geld
without	ohne
with the exception of	mit Ausnahme von
witness	Zeuge
wits	Verstand
wives	Ehefrauen
woken	aufgeweckt
woke up	weckte auf
wolf (irr.)	Wolf
wolves	Wölfe
woman (irr.)	Frau
women	Frauen
wonderfully	auf wunderbare Art und Weise
wonderful	wunderbar
wonder	Verwunderung
won	gewonnen
wooden	hölzern
wood	Wald
woolen	wollen (aus Wolle)
woolly	wollig
wool	Wolle
word of honour	Ehrenwort
word	Wort
wore	trug
workable	durchführbar
worker	Arbeiter(in)
working-class	Arbeiterklasse
working-day	Arbeitstag
workshop	Werkstatt
works	Werk
work under difficulties	unter Schwierigkeiten arbeiten
work	Werk
worldly	weltlich
world-record	Weltrekord
world	Welt
world-wide	weltweit
worm-eaten	von Würmern gefressen
worm	Wurm
worn	getragen (verb)
worn-out	abgenutzt
worry	Sorge
worse	schlimmer
worship	Verehrung
worst	schlimmste
worthless	wertlos
worth	Wert
worth-while	lohnend
worthy	würdig
would	würdet
would you like to ... ?	möchtest du ... ?
wounded	verwundet
wound	Wunde
wrap	einwickeln
wrapping paper	Einwickelpapier
wreck	zugrunde richten
wrist	Handgelenk
wristwatch	Armbanduhr
write (irr.)	schreiben
write it down	schreibe es nieder
writer	Schriftsteller(in)
writing	Schrift
written	geschrieben
wrongly	in ungerechter Weise
wrong	unrichtig
yard	Yard (Maß)
year	Jahr
yearly	jährlich
yellow	gelb
yes	ja
yesterday	gestern
yet	schon (bei Fragen)
yield	nachgeben
young	jung
your	euer
yourselves	euch selbst
yours faithfully	hochachtungsvoll
yours	Ihrer
yours sincerely	mit freundlichen Grüßen
you	Sie
youthful	jugendlich
youth	junger Mann
zebra crossing	Zebrastreifen
zebra	Zebra
zero	Null
zigzag	Zickzack
zip fastener	Reißverschluss (Br.)
zipper	Reißverschluss(US)
zip	Reißverschluss(Br.)
zither	Zither
zoo	Zoo
