ability; competence	才干 cái gàn 
ability; skill; source material; original story	本事 běn shi 
able; capable; competent; efficient	得力 dé lì 
a bonus; to award a bonus	分红 fēn hóng 
absence; absent	缺席 quē xí 
absolutely unrestrained; unbridled; without the slightest scruple	肆无忌惮 sì wú jì dàn 
absurd; ridiculous	荒谬 huāng miù 
abundant; affluent; richness; affluence	富裕 fù yù 
abundant; plentiful; vigorous	充沛 chōng pèi 
academic degree; e.g.: BSc 学士学位[xue2 shi4 xue2 wei4] , MSc 硕士学位[shuo4 shi4 xue2 wei4] , Diploma 学位证书[xue2 wei4 zheng4 shu1] , PhD 博士学位[bo2 shi4 xue2 wei4]	学位 xué wèi 
accent	口音 kǒu yīn 
accident; CL:桩[zhuang1] ,起[qi3] ,次[ci4]	事故 shì gù 
accomplishment; training; self-cultivation	修养 xiū yǎng 
according to; basis; foundation	依据 yī jù 
according to reports; it is reported (that)	据悉 jù xī 
accuracy; exact; precise; refined	精密 jīng mì 
accurate; precise	精确 jīng què 
a certain number or amount; how many?; how much?	若干 ruò gān 
a column (in a newspaper or on a news website)	栏目 lán mù 
acrobatics; CL:场[chang3]	杂技 zá jì 
act; action; activity; move; movement	举动 jǔ dòng 
act against one's will; have no alternative but to; have to; to have no choice; must	不得已 bù dé yǐ 
a danger concealed within sth; hidden damage; misfortune not visible from the surface	隐患 yǐn huàn 
add to; increase	增添 zēng tiān 
a defect; a flaw	缺陷 quē xiàn 
a delight to see (idiom); an attractive spectacle	喜闻乐见 xǐ wén lè jiàn 
adequate; sufficient; abundant	充足 chōng zú 
a dispute; entanglement (law)	纠纷 jiū fēn 
administration; administrative	行政 xíng zhèng 
admittedly (it's true that...)	固然 gù rán 
advanced (technology); to advance	先进 xiān jìn 
adviser; consultant	顾问 gù wèn 
(a feeling of) shame	羞耻 xiū chǐ 
affectionate; intimate; warm-hearted	亲热 qīn rè 
a foot's move sways the balance (idiom); to hold the balance of power; to play the decisive role	举足轻重 jǔ zú qīng zhòng 
after one's heart (idiom); gratifying and satisfactory; everything one could wish	称心如意 chèn xīn rú yì 
agreement; pact; protocol; CL:项[xiang4]	协议 xié yì 
a heavy load and a long road; fig. to bear heavy responsibilities through a long struggle (cf Confucian Analects, 8.7)	任重道远 rèn zhòng dào yuǎn 
a hybrid	杂交 zá jiāo 
alarm; alert; disturb	惊动 jīng dòng 
alcohol; ethanol CH3CH2OH; ethyl alcohol; also written 乙醇; grain alcohol	酒精 jiǔ jīng 
a list; to list; to enumerate	列举 liè jǔ 
all along; the whole time; constantly; earlier; lately	一向 yí xiàng 
all; each and every; in all cases	皆 jiē 
alliance; union; coalition	联盟 lián méng 
all of a sudden; hurriedly	仓促 cāng cù 
all over; from head to foot	浑身 hún shēn 
almost; nearly; close to	将近 jiāng jìn 
aloof; indifferent; unconcerned	无动于衷 wú dòng yú zhōng 
also	亦 yì 
always; all along	向来 xiàng lái 
always; throughout (a period of time); (of) all-time	历来 lì lái 
a (married) couple; husband and wife; CL:对[dui4]	夫妇 fū fù 
amazed; astonished; to surprise; amazing; astonishment; awe	惊讶 jīng yà 
ambiguous; vague	含糊 hán hu 
ambition; resolve; backbone; drive; spirit	志气 zhì qì 
ambition; wild schemes; careerism	野心 yě xīn 
ambush	埋伏 mái fú 
among the people; popular; folk; non-governmental; involving people rather than governments	民间 mín jiān 
amount; sum of money; fixed number	数额 shù é 
ample; complete; hundred percent; a pure shade (of some color)	十足 shí zú 
a musical score; sheet music	乐谱 yuè pǔ 
analogy; metaphor; figure of speech; figuratively	比喻 bǐ yù 
an assertion; to declare; to state	陈述 chén shù 
an association; a society; CL:个,家[jia1]	协会 xié huì 
an attack (esp. surprise attack); raid; to attack	袭击 xí jī 
an attack; under attack; a shock	冲击 chōng jī 
ancestor; forebears	祖先 zǔ xiān 
ancestral land CL:个; homeland; used for PRC	祖国 zǔ guó 
anchorage; mooring (of a ship)	停泊 tíng bó 
and then (what follows next)	进而 jìn ér 
anesthesia; fig. to poison (sb's mind)	麻醉 má zuì 
angry; indignant	愤怒 fèn nù 
animal from the Chinese zodiac; one of the twelve animals symbolic of the earthly branches 地支[di4 zhi1]	生肖 shēng xiào 
an instant (Sanskrit: ksana); split second; the twinkling of an eye	刹那 chà nà 
anniversary; annual	周年 zhōu nián 
announcement (written, on billboard, letter, newspaper or website); to post information; a notice	启事 qǐ shì 
an outline; silhouette	轮廓 lún kuò 
an overall plan taking into account all factors	统筹兼顾 tǒng chóu jiān gù 
ant;	蚂蚁 mǎ yǐ 
an unforeseen event; accident; misfortune	变故 biàn gù 
anxiety; anxious	焦急 jiāo jí 
anxious for quick results (idiom); to demand instant success; impatient for result; impetuous	急于求成 jí yú qiú chéng 
aperture; opening; hole	孔 kǒng 
a phrase-final particle	啦 lā 
a post; a job	岗位 gǎng wèi 
appearance; face; features; CL:个	面貌 miàn mào 
appearance; manner; bearing; deportment; look; expression; mien	神态 shén tài 
apprentice; disciple	徒弟 tú dì 
appropriate; proper; ready	妥当 tuǒ dang 
appropriate; proper	妥善 tuǒ shàn 
appropriate; suitable	恰当 qià dàng 
a pulse (both medical and figurative)	脉搏 mài bó 
arable land; to plow land	耕地 gēng dì 
a rally; to hold a rally; to join forces	团结 tuán jié 
arbitrary; at will; at random	任意 rèn yì 
archaeology	考古 kǎo gǔ 
area; region; district	区域 qū yù 
arms; equipment; to arm; military; armed (forces)	武装 wǔ zhuāng 
army troops; CL:支[zhi1] ,个	军队 jūn duì 
arm	臂 bì 
arrangement; composition; layout; opening (chess jargon)	布局 bù jú 
arrangement of ideas; administrative level; level; stage; phase	层次 céng cì 
arrangement; order; tidiness	条理 tiáo lǐ 
arrive; reach (a destination)	抵达 dǐ dá 
artery	动脉 dòng mài 
artificial; man-made; having human cause or origin; human attempt or effort	人为 rén wéi 
artificial; manpower; manual work	人工 rén gōng 
as before; (same) as usual	照样 zhào yàng 
as before; still	依旧 yī jiù 
as everyone knows (idiom)	众所周知 zhòng suǒ zhōu zhī 
as far as one's capabilities extend (idiom); to the best of one's ability; within one's powers	力所能及 lì suǒ néng jí 
a share (in a company); stock	股份 gǔ fèn 
as it should be by rights (idiom); proper and to be expected as a matter of course; inevitable and right	理所当然 lǐ suǒ dāng rán 
ask for instructions	请示 qǐng shì 
as one wishes; according to one's wishes; at will; voluntary; conscious	随意 suí yì 
aspect; phase; situation	局面 jú miàn 
aspiration; ambition	抱负 bào fù 
assailant; murderer; assassin	凶手 xiōng shǒu 
assistant; helper	助手 zhù shǒu 
assistant	助理 zhù lǐ 
a statue; a Buddhist image; sculpture; to carve	雕塑 diāo sù 
a strike; to go on strike	罢工 bà gōng 
astronomy	天文 tiān wén 
a struggle; fight; battle	斗争 dòu zhēng 
atmospheric pressure; barometric pressure	气压 qì yā 
at once; immediately; forthwith	顿时 dùn shí 
a trial; to try sb	审判 shěn pàn 
a trick; an ingenious method; know-how; the knack (of doing sth);	窍门 qiào mén 
at sb's invitation; on invitation	应邀 yìng yāo 
attachment; stubborn; be attached to; persistent; persevering;	执着 zhí zhuó 
attempt; CL:种[zhong3]	企图 qǐ tú 
at that time; originally	当初 dāng chū 
at the earliest possible time; as soon as possible	及早 jí zǎo 
at the minimum; at the very least	起码 qǐ mǎ 
at the scene; on the spot	当场 dāng chǎng 
attitude (of the heart); state of one's psyche; way of thinking; mentality	心态 xīn tài 
attitude; posture; stance	姿态 zī tài 
attract worldwide attention	举世瞩目 jǔ shì zhǔ mù 
at worst; if worst comes to worst; serious; alarming	大不了 dà bù liǎo 
aunt; wife of father's elder brother; (polite form of address for a woman who is about the age of one's mother); CL:个	伯母 bó mǔ 
authority; authoritative; power and prestige	权威 quán wēi 
avaricious; greedy; rapacious; insatiable; avid	贪婪 tān lán 
aviation	航空 háng kōng 
a way out (of a difficulty etc)	出路 chū lù 
a whistle; sentry	哨 shào 
a wide gap; big contrast; large disparity; a mismatch;	悬殊 xuán shū 
a wink; to signal with one's eyes	眼色 yǎn sè 
awkward; difficult; uncomfortable; not agreeing; at loggerheads; gauche; awkward (writing or speech)	别扭 biè niu 
awkward; embarrassed	尴尬 gān gà 
azure; sky blue;	蔚蓝 wèi lán 
baby; small child; doll	娃娃 wá wa 
backup	备份 bèi fèn 
bacterium; germ; CL:种[zhong3]	细菌 xì jūn 
bald; blunt	秃 tū 
bank; field-path	畔 pàn 
banking; finance; financial	金融 jīn róng 
barbarous; uncivilized	野蛮 yě mán 
barrier; obstruction; hindrance; impediment; obstacle	障碍 zhàng ài 
base (of operations); industrial or military base; al-Qaeda	基地 jī dì 
basin (low-lying geographical feature); depression	盆地 pén dì 
basket; CL:只[zhi1]	筐 kuāng 
beard; CL:根[gen1] ,绺[liu3]	胡须 hú xū 
beaten; exhausted; tired	疲惫 pí bèi 
beautiful; wonderful; splendid	美妙 měi miào 
be elected	当选 dāng xuǎn 
beforehand; prior	预先 yù xiān 
before; previously	先前 xiān qián 
beggar	乞丐 qǐ gài 
(begin to) develop; unfold; to start; to launch; to open; to carry out	开展 kāi zhǎn 
be in motion; to move; to run	运行 yùn xíng 
benefit	效益 xiào yì 
benevolent; charitable; kind; kindly; kindness; merciful	仁慈 rén cí 
benevolent; charitable;	慈善 cí shàn 
best feature; most important part of an object; quintessence; essence; soul	精华 jīng huá 
best seller; chart-topping	畅销 chàng xiāo 
be worthy of; deserve to be called; prove oneself to be	不愧 bú kuì 
beyond belief; preposterous; absurd; intemperate; dissipated	荒唐 huāng táng 
bias; deviation	偏差 piān chā 
biography; CL:篇[pian1] ,部[bu4]	传记 zhuàn jì 
birds and animals; the beasts of the field and the birds of the air	飞禽走兽 fēi qín zǒu shòu 
birthday	诞辰 dàn chén 
bitter and astringent; pained; agonized;	苦涩 kǔ sè 
bitter cold; severe winter	严寒 yán hán 
bitterness finishes, sweetness begins (idiom); the hard times are over, the good times just beginning	苦尽甘来 kǔ jìn gān lái 
blank space	空白 kòng bái 
blaze; flame	火焰 huǒ yàn 
blind; aimless	盲目 máng mù 
blistering hot; sizzling hot (weather)	炎热 yán rè 
blood pressure	血压 xuè yā 
blooming; in full flower	盛开 shèng kāi 
blurt out; to shout	嚷 rǎng 
boat	舟 zhōu 
body fat	脂肪 zhī fáng 
boiling; ebullition	沸腾 fèi téng 
bold; open-minded; heroic	豪迈 háo mài 
bond; debenture	债券 zhài quàn 
books; works	书籍 shū jí 
border area; borderland; frontier; frontier region	边疆 biān jiāng 
born of the same parents; fellow citizen or countryman	同胞 tóng bāo 
boundary; border	边界 biān jiè 
boundary; marginal	界限 jiè xiàn 
boundary; state; realm	境界 jìng jiè 
boundless; vast and obscure	茫茫 máng máng 
bow string; string of musical instrument; watchspring; chord (segment of curve); hypotenuse; CL:根[gen1]	弦 xián 
branch; classifier for sticks, rods, pencils etc	枝 zhī 
brand new	崭新 zhǎn xīn 
brave; heroic	壮烈 zhuàng liè 
bravery; gallant; valiant	英勇 yīng yǒng 
breast feeding; to suckle; to nurse	哺乳 bǔ rǔ 
breed; variety; CL:个	品种 pǐn zhǒng 
brick; CL:塊|块[kuai4];	砖 zhuān 
bridegroom; groom	新郎 xīn láng 
bride	新娘 xīn niáng 
bridge; fig. connection between two areas	桥梁 qiáo liáng 
bright; clear-cut; distinct	鲜明 xiān míng 
bright; smart; quick-witted; heart; thoughts; spirit	心灵 xīn líng 
brother's son; nephew;	侄子 zhí zi 
brown	棕色 zōng sè 
bud; flower bud;	花蕾 huā lěi 
budget	预算 yù suàn 
bullet; CL:粒[li4] ,颗[ke1] ,发[fa1]	子弹 zǐ dàn 
bumper harvest	丰收 fēng shōu 
bumpy; uneven; slotted and tabbed joint; crenelation	凹凸 āo tū 
burden; to bear a burden	负担 fù dān 
(business) transaction; business deal; CL:笔[bi3]	交易 jiāo yì 
busy; bustling	忙碌 máng lù 
busy; bustling	繁忙 fán máng 
buttocks; bottom; ass	屁股 pì gu 
button	纽扣儿 niǔ kòu r 
by fair means or foul; by hook or by crook; unscrupulously	不择手段 bù zé shǒu duàn 
cabin; the hold of a ship or airplane	舱 cāng 
calcium (chemistry);	钙 gài 
calligraphy; handwriting; penmanship	书法 shū fǎ 
callous; heartless	狠心 hěn xīn 
calm; cool	镇静 zhèn jìng 
calm; unperturbed; cool	镇定 zhèn dìng 
camera shot (in a movie etc); scene	镜头 jìng tóu 
cancer	癌症 ái zhèng 
candidate	候选 hòu xuǎn 
candle; CL:根[gen1] ,支[zhi1]	蜡烛 là zhú 
can; jar; pot	罐 guàn 
cannot bear; cannot stand; utterly; extremely	不堪 bù kān 
can't help; cannot but	不由得 bù yóu de 
can't help (doing sth); can't refrain from	不禁 bù jīn 
canyon; gill; ravine	峡谷 xiá gǔ 
capital (as in capitalism)	资本 zī běn 
capital (finance); assets; means	本钱 běn qián 
captive	俘虏 fú lǔ 
carbon dioxide; CO2	二氧化碳 èr yǎng huà tàn 
carefree and without worries (idiom)	无忧无虑 wú yōu wú lv4 
careful; thorough	周密 zhōu mì 
careless; negligent; sloppy; not serious	草率 cǎo shuài 
careless; reckless; casually; absent-mindedly; at will; at random; any old how	胡乱 hú luàn 
care; solicitude; to show care for; concerned about; attentive to	关怀 guān huái 
caricature; cartoon; Japanese manga	漫画 màn huà 
cartoon	卡通 kǎ tōng 
case (law); CL:个	案例 àn lì 
castle; rook (chess piece)	城堡 chéng bǎo 
category	范畴 fàn chóu 
cautious and conscientious	兢兢业业 jīng jīng yè yè 
cautious and solemn (idiom); very carefully; prudent; gently and cautiously	小心翼翼 xiǎo xīn yì yì 
cautious; careful; prudent	慎重 shèn zhòng 
cavity; empty; vacuous	空洞 kōng dòng 
celebration; ceremony	典礼 diǎn lǐ 
cell (biology)	细胞 xì bāo 
cement; CL:袋[dai4]	水泥 shuǐ ní 
center of gravity; central core; main part	重心 zhòng xīn 
central; middle; center; central authorities (of a state)	中央 zhōng yāng 
ceremony	仪式 yí shì 
cervical vertebra; the seven cervical vertebrae in the neck of humans and most mammals	颈椎 jǐng zhuī 
chain	连锁 lián suǒ 
chairman of the board; chairman	董事长 dǒng shì zhǎng 
changes; vicissitudes	变迁 biàn qiān 
chaste; virtuous	贤惠 xián huì 
cheap and fine; attractive in price and quality	物美价廉 wù měi jià lián 
chest	胸膛 xiōng táng 
children's fairy tales	童话 tóng huà 
Chinese-style dress; cheongsam	旗袍 qí páo 
circumference;	方圆 fāng yuán 
circumstances; situation; CL:个	情形 qíng xíng 
citizen	公民 gōng mín 
classifier for coins, rings, badges, pearls, sporting medals, rockets, satellites etc	枚 méi 
classifier for houses or buildings; ridgepole (old)	栋 dòng 
classifier for ships; Taiwan pr. sao1	艘 sōu 
clause (of contract or law); CL:项[xiang4]	条款 tiáo kuǎn 
clean; purity	清洁 qīng jié 
clear; distinct	清晰 qīng xī 
clear-headed; sober; awake	清醒 qīng xǐng 
clear; limpid	清澈 qīng chè 
clearly demarcated; sharply contoured	分明 fēn míng 
clear (of liquid); limpid; to clarify; to make sth clear; to be clear (about the facts)	澄清 chéng qīng 
clear; to put in order; to check up	清理 qīng lǐ 
clever; quick-witted	机灵 jī ling 
clever; witty; intelligent	伶俐 líng lì 
client; customer	客户 kè hù 
cliffside	悬崖峭壁 xuán yá qiào bì 
clinical	临床 lín chuáng 
clothes	衣裳 yī shang 
cloth-wrapper; a bundle wrapped in cloth; load; weight; burden	包袱 bāo fu 
club	棍棒 gùn bàng 
clumsy; awkward; stupid	笨拙 bèn zhuō 
cluster; collection; collection of books; thicket	丛 cóng 
coastal	沿海 yán hǎi 
(coll.) all day long; all the time	成天 chéng tiān 
collapse	塌 tā 
(coll.) serve sb right; deservedly; ought; should	活该 huó gāi 
colony	殖民地 zhí mín dì 
comic dialog; sketch; crosstalk;	相声 xiàng sheng 
commanding officer	司令 sī lìng 
committee member; committee; council; CL:个	委员 wěi yuán 
common; everyday; average	通俗 tōng sú 
commonplace; ordinary; mediocre	平凡 píng fán 
common saying; proverb	俗话 sú huà 
common (use); interchangeable	通用 tōng yòng 
communications; a news story (e.g. dispatched over the wire); CL:个	通讯 tōng xùn 
communication; to get in touch with; to contact; connection (math.)	联络 lián luò 
community	社区 shè qū 
compartment; gap; interval; to divide	间隔 jiàn gé 
compass	指南针 zhǐ nán zhēn 
compensate; make up	补偿 bǔ cháng 
complacent; self-satisfied	自满 zì mǎn 
complainant; plaintiff	原告 yuán gào 
complaint; to file a complaint; to sue	投诉 tóu sù 
complete	齐全 qí quán 
complexion	气色 qì sè 
complicated; winding	曲折 qū zhé 
complication; twists and turns; problem; setback	周折 zhōu zhé 
comrade; homosexual (slang); CL:个	同志 tóng zhì 
concise; brief	简要 jiǎn yào 
conclusion; ending	结局 jié jú 
condiment; seasoning; flavoring	调料 tiáo liào 
condition; situation; plight; extent; room for action	地步 dì bù 
confident and at ease; free and easy;	潇洒 xiāo sǎ 
conflict; to conflict; clash of opposing forces; collision (of interests); contention	冲突 chōng tū 
Confucianism; Confucian school, founded by Confucius 孔子[Kong3 zi3] (551-479 BC) and Mencius 孟子[Meng4 zi3] (c. 372-c. 289 BC);	儒家 rú jiā 
confusion; chaos; disorder	混乱 hùn luàn 
conquer; subdue; vanquish	征服 zhēng fú 
conscience	良心 liáng xīn 
consciousness; awareness; Buddhist enlightenment (Sanskrit: cittotpāda)	觉悟 jué wù 
consciousness; awareness; consciously (i.e. deliberately); to be aware	意识 yì shí 
considerable	可观 kě guān 
considerably; rather; inclined to one side	颇 pō 
consistent; constant; from start to finish; all along; persistent	一贯 yí guàn 
consort; mate; spouse	配偶 pèi ǒu 
constitution (of a country)	宪法 xiàn fǎ 
consulate	领事馆 lǐng shì guǎn 
consult	请教 qǐng jiào 
contemplate; contemplation; meditation; ponder	沉思 chén sī 
contemptible; despicable; base; mean	卑鄙 bēi bǐ 
contestant; athlete	选手 xuǎn shǒu 
continuously; in an endless stream (idiom)	络绎不绝 luò yì bù jué 
contribution; meritorious service; credit	功劳 gōng láo 
controversy; dispute	争议 zhēng yì 
convenient; easy; facilitate	便利 biàn lì 
conventional	惯例 guàn lì 
cooking; culinary arts	烹饪 pēng rèn 
copper (chemistry); see also 紅红铜[hong2 tong2]; CL:块[kuai4]	铜 tóng 
corridor; aisle; hallway; colonnade; passageway; piazza; veranda	走廊 zǒu láng 
corrosion; to corrode (degrade chemically); to rot; corruption	腐蚀 fǔ shí 
corruption; corrupt; rotten	腐败 fǔ bài 
corruption	贪污 tān wū 
cotton	棉花 mián hua 
countermeasure for dealing with a situation	对策 duì cè 
courage; daring; boldness; resolution; drive	魄力 pò lì 
crack; gap between two objects; gap in time between two events	空隙 kòng xì 
craftmanship; workmanship; handicraft; trade	手艺 shǒu yì 
crash; break up	粉碎 fěn suì 
credentials; certificate	证书 zhèng shū 
creek; rivulet	溪 xī 
criminal; penal	刑事 xíng shì 
criminal	罪犯 zuì fàn 
crisis; CL:个	危机 wēi jī 
criticize; CL:个	批判 pī pàn 
crude; coarse; rough	粗鲁 cū lǔ 
cruel; ruthless; cruelty	残酷 cán kù 
crumbs; filings; worthwhile	屑 xiè 
crutches; crutch; walking stick	拐杖 guǎi zhàng 
crystallization; crystalline; crystal	结晶 jié jīng 
cube	立方 lì fāng 
cultural relic; historical relic; CL:件[jian4] ,个	文物 wén wù 
curio; antique	古董 gǔ dǒng 
currency; monetary; money	货币 huò bì 
current situation	现状 xiàn zhuàng 
current; today's; modern; present; to be facing (us)	当前 dāng qián 
current trends; the present situation; how things are going	时事 shí shì 
custom; tradition; local tradition; convention	习俗 xí sú 
daily renewal, monthly change (idiom); every day sees new developments; rapid progress	日新月异 rì xīn yuè yì 
dam;	堤坝 dī bà 
dance	舞蹈 wǔ dǎo 
Daoist immortal; supernatural entity; (in modern fiction) fairy, elf, leprechaun etc; fig. lighthearted person; used in advertising: Live like an immortal! 活神仙似	神仙 shén xiān 
daughter-in-law; wife (of a younger man); young married woman; young woman	媳妇 xí fu 
dawn; daybreak	黎明 lí míng 
day and night; period of 24 hours; continuously, without stop	昼夜 zhòu yè 
day by day; more and more; increasingly; more and more with each passing day	日益 rì yì 
daydream; fantasy; to fantasize	空想 kōng xiǎng 
dead body; corpse; carcass; CL:具[ju4]	尸体 shī tǐ 
deaf and dumb; deaf-mute; surdimutism	聋哑 lóng yǎ 
death; deadly	死亡 sǐ wáng 
decent; honorable; proper; serious; according to standards	正经 zhèng jing 
decide by vote; vote	表决 biǎo jué 
deed; past achievement; important event of the past	事迹 shì jì 
deep; extreme; dull; low pitched (sound)	深沉 shēn chén 
deep-rooted (problem etc)	根深蒂固 gēn shēn dì gù 
defect; fault	过失 guò shī 
defendant	被告 bèi gào 
defend; protect (against)	防守 fáng shǒu 
defend; uphold; safeguard	捍卫 hàn wèi 
defense	防御 fáng yù 
deferential; with respect	恭敬 gōng jìng 
deficit; (financial) loss	亏损 kuī sǔn 
definite; exact; precise	确切 què qiè 
definition	定义 dìng yì 
degree; rate	等级 děng jí 
degrees centigrade	摄氏度 shè shì dù 
delicate; fine; careful; meticulous; painstaking	细致 xì zhì 
delicate; fine; exquisite; refined	精致 jīng zhì 
delicate; squeamish; finicky	娇气 jiāo qì 
delighted to (do sth, idiom); perfectly happy to do; most willing to do;	心甘情愿 xīn gān qíng yuàn 
delight; pleasure; joy	乐趣 lè qù 
deluge; flood	洪水 hóng shuǐ 
democracy	民主 mín zhǔ 
denomination; group; school; faction; school of thought	派别 pài bié 
dense; thick (fog, clouds etc); to have a strong interest in; deep; fully saturated (color)	浓厚 nóng hòu 
dense	稠密 chóu mì 
density; thickness	密度 mì dù 
depot; storehouse; warehouse	仓库 cāng kù 
derogatory sense; negative connotation	贬义 biǎn yì 
design; pattern	图案 tú àn 
desire; longing; appetite; craving	欲望 yù wàng 
desolate; unfrequented; to treat sb coldly; to snub; to cold shoulder;	冷落 lěng luò 
desolate	凄凉 qī liáng 
desolate	荒凉 huāng liáng 
desperation; forlorn; hopeless	绝望 jué wàng 
detective; to do detective work	侦探 zhēn tàn 
development; trend; dynamic state; movement; moving	动态 dòng tài 
devil	魔鬼 mó guǐ 
devoted; fidelity; loyal; loyalty	忠诚 zhōng chéng 
(dialect) what	啥 shá 
(dialect) why; how; what	咋 zǎ 
dialect	方言 fāng yán 
diameter;	直径 zhí jìng 
diamond; CL:颗[ke1]	钻石 zuàn shí 
diaphysis (long segment of a bone); fig. backbone	骨干 gǔ gàn 
diarrhea; to have the runs	腹泻 fù xiè 
dictatorship	独裁 dú cái 
diesel fuel	柴油 chái yóu 
difference; distinction; diversity; disparity	差别 chā bié 
difference; error; inaccuracy	误差 wù chā 
difference (of opinion, position); bifurcation	分歧 fēn qí 
difficult; hard; challenging	艰难 jiān nán 
dignity; face (as in 'losing face'); honorable; creditable; pretty	体面 tǐ miàn 
dignity; sanctity; honor; majesty	尊严 zūn yán 
digression; gossip; complaint; scandal; CL:段[duan4]	闲话 xián huà 
diploma	文凭 wén píng 
direction; points of the compass; bearing; position; azimuth	方位 fāng wèi 
directly; head-on (collision); in one's face (of wind)	迎面 yíng miàn 
disabled; handicapped; deformity on a person or animal	残疾 cán jí 
disaster; catastrophe	灾难 zāi nàn 
discard; dump; abandon	抛弃 pāo qì 
discontent; complaint	牢骚 láo sāo 
discouraged; dejected; demoralized; despairing; to want to give up; to deflate (air from a tyre)	泄气 xiè qì 
disease; sickness; ailment	疾病 jí bìng 
dispirited and downcast (idiom); listless; in low spirits; washed out	无精打采 wú jīng dǎ cǎi 
dispirited; dejected; dismayed	沮丧 jǔ sàng 
disposition	意向 yì xiàng 
dispute; controversy; conflict	争端 zhēng duān 
dissolve; disband	解散 jiě sàn 
dissolve; solution	溶解 róng jiě 
distant; remote	遥远 yáo yuǎn 
distinction; excellence; outstanding; surpassing; distinguished; splendid	卓越 zhuó yuè 
distribute; emit; issue	散发 sàn fā 
diversification; pluralism; to diversify	多元化 duō yuán huà 
divine; hallow; holy; sacred	神圣 shén shèng 
do at all costs; make an all-out effort	全力以赴 quán lì yǐ fù 
dock; pier; wharf; CL:个	码头 mǎ tóu 
doctrine; ideology; -ism	主义 zhǔ yì 
document	文献 wén xiàn 
dog	犬 quǎn 
domesticated animals; livestock	牲畜 shēng chù 
double-edged sword; CL:口[kou3],把[ba3]; classifier for blows of a sword;	剑 jiàn 
down garment	羽绒服 yǔ róng fú 
down to; up to; to such an extent as to... (also written 以至以至于[yi3 zhi4 yu2])	以至 yǐ zhì 
draft (a bill); draw up (plans)	起草 qǐ cǎo 
draft (legislation, proposal etc)	草案 cǎo àn 
drill; practice	操练 cāo liàn 
drought; arid; dry	干旱 gān hàn 
drugs; narcotics; poison	毒品 dú pǐn 
dry and dull; uninteresting; dry-as-dust	枯燥 kū zào 
durable	耐用 nài yòng 
during; at the time of;	之际 zhī jì 
dusk; evening; nightfall	黄昏 huáng hūn 
dynasty; reign (of a king)	朝代 cháo dài 
eager; impatient	急切 jí qiè 
early in the morning	凌晨 líng chén 
early morning	清晨 qīng chén 
earnest; sincere	恳切 kěn qiè 
earnings; profit	收益 shōu yì 
easy to; convenient for	便于 biàn yú 
eccentric; grotesque; oddly; queer	古怪 gǔ guài 
edge; fringe; verge; brink; periphery; marginal; borderline	边缘 biān yuán 
effect; result	成效 chéng xiào 
efficacy	功效 gōng xiào 
electric power source	电源 diàn yuán 
elegance (for men); elegant demeanor; grace; poise	风度 fēng dù 
elegant; refined	文雅 wén yǎ 
element; element of a set; chemical element	元素 yuán sù 
eliminate; get rid of	清除 qīng chú 
emergency relief; to help the needy with cash or goods	救济 jiù jì 
emission; discharge; exhaust (gas etc)	排放 pái fàng 
emperor; CL:个	皇帝 huáng dì 
empress; imperial consort	皇后 huáng hòu 
enclosure; attachment (email); appendix	附件 fù jiàn 
end; extremity; item; port; to hold sth level with both hands; to carry; regular	端 duān 
energy; capabilities	能量 néng liàng 
energy; vitality; vigor; vital force	活力 huó lì 
engine (transliteration)	引擎 yǐn qíng 
enjoy market dominance; monopolize	垄断 lǒng duàn 
enlightened; open-minded; enlightenment	开明 kāi míng 
enlightenment; revelation; apocalypse	启示 qǐ shì 
ensign; flag	旗帜 qí zhì 
entail strenuous effort; be a strain	吃力 chī lì 
enthusiasm for doing sth	干劲 gàn jìn 
entranced; Trance (music genre)	出神 chū shén 
equal; equally; equivalent	相等 xiāng děng 
equally matched; about the same	不相上下 bù xiāng shàng xià 
equator (of the earth or astronomical body)	赤道 chì dào 
equipment; material	器材 qì cái 
equipment; to equip; to outfit	装备 zhuāng bèi 
essential factor; key constituent	要素 yào sù 
esthetics; appreciating the arts; taste	审美 shěn měi 
estrangement	隔阂 gé hé 
eternal; everlasting; fig. to pass into eternity (i.e. to die)	永恒 yǒng héng 
etiquette	礼节 lǐ jié 
even if; even though; right away; immediately	即便 jí biàn 
event; happening; incident; CL:个	事件 shì jiàn 
every; all	凡是 fán shì 
everybody; everyone; we all	大伙儿 dà huǒ r 
everyone gives their own view	各抒己见 gè shū jǐ jiàn 
evil-doer; malefactor; gangster; hoodlum	歹徒 dǎi tú 
evolution; CL:个	进化 jìn huà 
example; model; CL:个	榜样 bǎng yàng 
excellent; superlative	高超 gāo chāo 
exceptional; abnormal; an anomaly	异常 yì cháng 
exceptional; outstandingly good	优异 yōu yì 
excessive; over-; excess; going too far; extravagant; intemperate; overdue	过度 guò dù 
exchanging conventional greetings; to talk about the weather	寒暄 hán xuān 
exercise; practice; to put on a play; to act	演习 yǎn xí 
expansion; dilation; to expand (e.g. one's power or influence); to broaden	扩张 kuò zhāng 
expect; expected	预期 yù qī 
expenditures; pay; expenses; CL:笔[bi3]	开支 kāi zhī 
expensive; costly	昂贵 áng guì 
experienced and knowledgeable (idiom)	见多识广 jiàn duō shí guǎng 
experiment; test; experimental; CL:次[ci4] ,个	试验 shì yàn 
expert in; good at	拿手 ná shǒu 
exploration	勘探 kān tàn 
explosion; to explode; to blow up; to detonate	爆炸 bào zhà 
exposition; international fair	博览会 bó lǎn huì 
exposure (e.g. of photosensitive material); to expose (a scandal to the public)	曝光 bào guāng 
expression; manner; spirited; vigorous	神气 shén qì 
expression or emotion showing in one's eyes; meaningful glance; wink; eyesight (topolect)	眼神 yǎn shén 
external; outside; outward appearance	外表 wài biǎo 
extra; added; additional	额外 é wài 
extreme	极端 jí duān 
eyes brimming with tears of excitement (idiom); extremely moved	热泪盈眶 rè lèi yíng kuàng 
fable; CL:则[ze2]	寓言 yù yán 
faith; belief; conviction	信念 xìn niàn 
faithful	忠实 zhōng shí 
false; hypocritical; artificial; sham	虚伪 xū wěi 
false; phony; pretense	虚假 xū jiǎ 
fame; reputation; honor; honorary; emeritus (of retired professor)	名誉 míng yù 
family background; class origin	出身 chū shēn 
family member; (family) dependent	家属 jiā shǔ 
fantastic; wonderful	奇妙 qí miào 
farm crop; CL:種|种[zhong3];	庄稼 zhuāng jià 
fascinating; enchanting; charming; tempting	迷人 mí rén 
father's father; paternal grandfather	祖父 zǔ fù 
faucet; tap	水龙头 shuǐ lóng tóu 
faultless; complete; perfect; to leave nothing to be desired	完备 wán bèi 
fear; dread; phobia	恐惧 kǒng jù 
fears of trouble in the rear (idiom); family worries (obstructing freedom of action); worries about the future consequences; often in negative expressions, meaning 'no worries about anything'	后顾之忧 hòu gù zhī yōu 
feasible; earnestly; conscientiously; realistic; practical	切实 qiè shí 
feasible	可行 kě xíng 
feel embarrassed or awkward; to make things difficult (for someone); to find things difficult (to do or manage)	为难 wéi nán 
feeling inferior; self-abased	自卑 zì bēi 
(feeling of) resentment; (longstanding) grudge	恩怨 ēn yuàn 
fertile	肥沃 féi wò 
fertilizer	化肥 huà féi 
fiber; CL:种[zhong3]	纤维 xiān wéi 
field of view; horizon	视野 shì yě 
field; open land; CL:片[pian4]	田野 tián yě 
field; plain; CL:个	平原 píng yuán 
fierce; ferocious; fiendish; frightening	凶恶 xiōng è 
fierce; violent (criticism etc)	猛烈 měng liè 
fight over; contest; vie over	争夺 zhēng duó 
file; record; archive; Taiwan pr. dang3 an4	档案 dàng àn 
filthy; vulgar; debased	庸俗 yōng sú 
finances (public); financial	财政 cái zhèng 
financial affairs	财务 cái wù 
(financial) deficit; red letter	赤字 chì zì 
find a place for; help settle down; arrange for; to get into bed; placement	安置 ān zhì 
fine food; delicacies; delicious food	佳肴 jiā yáo 
fine powder; dust	粉末 fěn mò 
fingernail	指甲 zhǐ jia 
fire-fighting; fire control	消防 xiāo fáng 
fireworks and crackers	烟花爆竹 yān huā bào zhú 
firm and substantial; solid	坚实 jiān shí 
firm; decisive	果断 guǒ duàn 
firm; firmly; hard; stable	坚固 jiān gù 
firmly; resolutely; without hesitation	毅然 yì rán 
firm; secure	牢固 láo gù 
firm; steady; staunch; resolute	坚定 jiān dìng 
first month of the lunar year	正月 zhēng yuè 
first; original; primitive; original (document etc)	原始 yuán shǐ 
fisherman; fisher folk	渔民 yú mín 
fishy (smell)	腥 xīng 
fist; clenched fist; competitive (product); superior quality; CL: 个	拳头 quán tou 
fixed number of people; quota	名额 míng é 
flabbergasted; astonished	诧异 chà yì 
flat; (old form of character 匾, horizontal tablet with inscription)	扁 biǎn 
flexibility; elasticity (physics)	弹性 tán xìng 
flicker; twinkling	闪烁 shǎn shuò 
flourishing; bustling	繁华 fán huá 
fly	飞翔 fēi xiáng 
foam; (soap) bubble; (economic) bubble	泡沫 pào mò 
focus; focal point	焦点 jiāo diǎn 
food and drink	饮食 yǐn shí 
for a time; at one time; one time; once	一度 yí dù 
foreground; vista; (future) prospects; perspective	前景 qián jǐng 
for example; for instance; such as	譬如 pì rú 
forgetful; scatterbrained	丢三落四 diū sān là sì 
forgiveness; spare	饶恕 ráo shù 
fork in road; bifurcation; branch in road, river, mountain range etc; to branch off; to turn off; to diverge; to stray (from the path); to change the subject; to interrupt; to stagger (times)	岔 chà 
formerly; in olden days	昔日 xī rì 
former; original	原先 yuán xiān 
form; specification; format	格式 gé shì 
formula	公式 gōng shì 
for now; for the time being; temporarily	暂且 zàn qiě 
fortunately; unexpectedly; by coincidence	恰巧 qià qiǎo 
fortunate timing; occasion; opportunity	时机 shí jī 
forum (for discussion)	论坛 lùn tán 
fossil	化石 huà shí 
fountainhead; well-spring; water source; fig. origin	源泉 yuán quán 
fourth of 10 heavenly stems 十天干; man; members of a family	丁 dīng 
fragmentary; random; bits and pieces; sporadic	零星 líng xīng 
frame; framework; fig. pattern; outline; organizing plan	框架 kuàng jià 
free; no charge; at no cost	无偿 wú cháng 
frequency	频率 pín lv4 
frequently; often	不时 bù shí 
frequently; often	频繁 pín fán 
friction; rubbing; chafing; fig. disharmony; conflict; same as 磨擦	摩擦 mó cā 
friendly; polite; amiable	和气 hé qi 
frontier; border	边境 biān jìng 
full of youthful energy (idiom); vigorous; energetic; a bright spark	朝气蓬勃 zhāo qì péng bó 
function; performance	性能 xìng néng 
function; role	职能 zhí néng 
funds; expenditure; CL:笔[bi3]	经费 jīng fèi 
fund	基金 jī jīn 
fun; interest; delight; taste; liking; preference	趣味 qù wèi 
gaiety; gladness; glee; merriment; pleasure; happy; joyous; gay	欢乐 huān lè 
gardens; park; landscape garden	园林 yuán lín 
gaze	凝视 níng shì 
gene (loanword)	基因 jī yīn 
general idea; main idea	大意 dà yì 
general mood; atmosphere; common practice	风气 fēng qì 
generation; an era; accumulation of years; passing on from generation to generation	世代 shì dài 
genre; style; form of writing	体裁 tǐ cái 
gentleman	绅士 shēn shì 
gentle; soft	柔和 róu hé 
geology	地质 dì zhì 
gesture; sign; signal	手势 shǒu shì 
gift; innate skill	天赋 tiān fù 
give as a present; present as a gift	赠送 zèng sòng 
gluttonous; greedy; to have a craving	馋 chán 
good fortune; to enjoy good fortune	福气 fú qi 
goods and materials	物资 wù zī 
go on a journey; leave	动身 dòng shēn 
gorgeous	华丽 huá lì 
grade; class; quality; level	档次 dàng cì 
grain; granule; classifier for small round things (peas, bullets, peanuts, pills, grains etc)	粒 lì 
grand; imposing; magnificent; majestic	雄伟 xióng wěi 
grand; imposing; magnificent	宏伟 hóng wěi 
grand; prosperous; ceremonious; solemn	隆重 lóng zhòng 
grave; solemn; dignified	庄重 zhuāng zhòng 
grease; greasy food; oily; rich (of food); fatty; greasy and dirty; a slippery character	油腻 yóu nì 
great kindness; magnificent hospitality	盛情 shèng qíng 
great waves; billows;	波涛 bō tāo 
grieved; sorrowful	悲哀 bēi āi 
grim; severe; rigorous	严峻 yán jùn 
grim; unfeeling; callous	冷酷 lěng kù 
group; bloc; corporation; conglomerate	集团 jí tuán 
group; organization; team; CL:个	团体 tuán tǐ 
guided missile; cruise missile; missile; CL:枚[mei2]	导弹 dǎo dàn 
guide	向导 xiàng dǎo 
gunpowder	火药 huǒ yào 
habitually in the past; as one used to do formerly; as it used to be	往常 wǎng cháng 
hail; hailstone; CL:场[chang2] ,粒[li4]	冰雹 bīng báo 
hammer; to hammer into shape; weight (e.g. of a steelyard or balance)	锤 chuí 
handicraft article; handiwork; CL:个	工艺品 gōng yì pǐn 
handle; grip; knob	把手 bǎ shǒu 
happy and excited (idiom); in high spirits; in great delight	兴高采烈 xīng gāo cǎi liè 
happy; blissful	美满 měi mǎn 
happy; cheerful	快活 kuài huo 
happy; entirely free from worry	舒畅 shū chàng 
happy; joyous	喜悦 xǐ yuè 
hard; solid	坚硬 jiān yìng 
hard to take; embarrassed	难堪 nán kān 
hardworking and frugal	勤俭 qín jiǎn 
hardworking; industrious; diligent	勤劳 qín láo 
hardworking; industrious	辛勤 xīn qín 
harmonious; friendly relations; on good terms with one another	融洽 róng qià 
harmonious; harmony	调和 tiáo hé 
harmonious	和谐 hé xié 
hatred; injustice; bad luck; unjust treatment; wronged; not worthwhile	冤枉 yuān wang 
have a get-together	联欢 lián huān 
having lived through many changes	饱经沧桑 bǎo jīng cāng sāng 
head of state	元首 yuán shǒu 
heal; the more...the more; to recover; better	愈 yù 
healthy environment; healthy atmosphere; righteousness; vital energy (in Chinese medicine)	正气 zhèng qì 
heartfelt; wholehearted; cordial	衷心 zhōng xīn 
heart's blood; expenditure (for some project); meticulous care	心血 xīn xuè 
heavy drinking; to get drunk; to drink to excess	酗酒 xù jiǔ 
heavy; hard; serious; critical	沉重 chén zhòng 
height above sea level; elevation	海拔 hǎi bá 
heredity; inheritance; to transmit	遗传 yí chuán 
heritage; legacy; inheritance; bequest; CL:笔[bi3]	遗产 yí chǎn 
hey	嘿 hēi 
hierarchy; stratum	阶层 jiē céng 
higher authorities; superiors; CL:个	上级 shàng jí 
high tide; high water; upsurge; climax; orgasm; chorus (part of a song)	高潮 gāo cháo 
hills	丘陵 qiū líng 
history; antecedents; origin	来历 lái lì 
hollow; emptiness; meaningless	空虚 kōng xū 
home; homeland; native place; CL:个	故乡 gù xiāng 
honest; forthcoming; to confess	坦白 tǎn bái 
honest; not coercive; honesty; integrity; incorruptible	廉洁 lián jié 
honest; reasonable; fair; sensible; timely; just (when needed)	正当 zhèng dāng 
honor and glory; CL:个	光荣 guāng róng 
honor; credit; glory; (honorable) reputation	荣誉 róng yù 
honored	荣幸 róng xìng 
hoodlum; rascal; rogue; rascally; scoundrelly	无赖 wú lài 
hook	钩子 gōu zi 
hope; expectation	期望 qī wàng 
horizontal; across; (horizontal character stroke)	横 héng 
horn (automobile, alarm siren, musical etc) which produces a sound; loudspeaker; brass wind instrument; trumpet; suona 鎖锁呐[suo3 na4]	喇叭 lǎ ba 
hostage	人质 rén zhì 
hostile; malevolence; antagonism; to view as enemy; to stand against	敌视 dí shì 
host; official host (e.g. venue for games or a conference)	东道主 dōng dào zhǔ 
household dish, implement or furniture; domestic animal; guy (slang); chap	家伙 jiā huo 
how can this be so? (idiom); preposterous; ridiculous; absurd	岂有此理 qǐ yǒu cǐ lǐ 
hubbub; clamor; to make a racket;	喧哗 xuān huá 
huge; enormous; tremendous	庞大 páng dà 
human nature; humanity; human; the totality of human attributes	人性 rén xìng 
human sympathy; humanitarianism; humane; the 'human way', one of the stages in the cycle of reincarnation (Buddhism); sexual intercourse	人道 rén dào 
humble; humility; modesty	谦逊 qiān xùn 
humor; wit; humorous; witty	风趣 fēng qù 
hunger; starvation; famine	饥饿 jī è 
hurricane; typhoon	台风 tái fēng 
idle; lazy	懒惰 lǎn duò 
idol; false god	偶像 ǒu xiàng 
ignorance	无知 wú zhī 
ignorant; to have no knowledge of sth	茫然 máng rán 
ignorant; uneducated	愚昧 yú mèi 
illegal	非法 fēi fǎ 
immediately; presently; following which	随即 suí jí 
immunity (to disease)	免疫 miǎn yì 
impatient (idiom); in a hurry; itching to get on with it	迫不及待 pò bù jí dài 
imperceptible influence; to influence secretly	潜移默化 qián yí mò huà 
impetus; impulse; emotional impulse; impulsive	冲动 chōng dòng 
implement; carry out; to execute; to run	执行 zhí xíng 
impotent (idiom); powerless; helpless	无能为力 wú néng wéi lì 
impoverished; poverty	贫困 pín kùn 
improve	改良 gǎi liáng 
in a difficult situation; to cut a sorry figure; scoundrel! (derogatory)	狼狈 láng bèi 
incessantly; without end; more than; not limited to	不止 bù zhǐ 
in charge; responsible for	主管 zhǔ guǎn 
inconceivable (idiom); unimaginable; unfathomable	不可思议 bù kě sī yì 
(indicates that sth turns out just the opposite of what one would expect or what would be normal); unfortunately; against expectations	偏偏 piān piān 
indirect	间接 jiàn jiē 
individual	个体 gè tǐ 
industry; estate; property; industrial	产业 chǎn yè 
in every possible way (idiom); meticulous	无微不至 wú wēi bù zhì 
infant; baby; CL:个; lead (Pb)	婴儿 yīng ér 
infection; to infect; to influence	感染 gǎn rǎn 
inflamed from infection or injury; inflammation	发炎 fā yán 
inflation	通货膨胀 tōng huò péng zhàng 
(informal) note; CL:张[zhang1] ,个	便条 biàn tiáo 
(informal) older brother's wife; sister-in-law; CL:个	嫂子 sǎo zi 
in front of; close to; nearby; the time just before	跟前 gēn qián 
in general; more or less; in rough terms; basically; on the whole	大体 dà tǐ 
initial; preliminary; tentative	初步 chū bù 
in itself; per se; itself	本身 běn shēn 
injection; to inject	注射 zhù shè 
ink; CL:瓶[ping2]	墨水儿 mò shuǐ r 
innate; natural	天生 tiān shēng 
inner quality; basic essence; change over time	素质 sù zhì 
innocent; innocence; not guilty (law);	无辜 wú gū 
innovation; to bring forth new ideas; to blaze new trails	创新 chuàng xīn 
in order to avoid; so as not to	以免 yǐ miǎn 
(in) return; reciprocation; payback; retaliation; to report back; to reciprocate	回报 huí bào 
in sequence, step by step (idiom); to make steady progress incrementally	循序渐进 xún xù jiàn jìn 
in short; in a word; in brief	总而言之 zǒng ér yán zhī 
inside story; non-public information; behind the scenes; internal	内幕 nèi mù 
in silence; not speaking	默默 mò mò 
inspiration; insight; a burst of creativity in scientific or artistic endeavor	灵感 líng gǎn 
in spite of; regardless of	不顾 bú gù 
instance; example	比方 bǐ fang 
instinct	本能 běn néng 
instrument; apparatus; CL:台[tai2]	仪器 yí qì 
intelligence; intellect	智力 zhì lì 
intelligent; able; smart (phone, system, bomb etc)	智能 zhì néng 
intent; intention; intend; schematic diagram	意图 yì tú 
intentional; deliberate; on purpose	成心 chéng xīn 
in the end; after all is said and done	终究 zhōng jiū 
in the past; formerly	以往 yǐ wǎng 
in the right and self-confident (idiom); bold and confident with justice on one's side; to have the courage of one's convictions; just and forceful	理直气壮 lǐ zhí qì zhuàng 
intimate; close;	亲密 qīn mì 
intrinsic; innate	内在 nèi zài 
intrinsic to sth; inherent; native	固有 gù yǒu 
invasion; encroachment	侵略 qīn lvè 
investigate; look into	追究 zhuī jiū 
in view of; seeing that; considering; whereas	鉴于 jiàn yú 
invitation card; written invitation	请帖 qǐng tiě 
invitation card; written invitation	请柬 qǐng jiǎn 
in writing; written (guarantee etc)	书面 shū miàn 
IQ (intelligence quotient)	智商 zhì shāng 
irrigation ditch; medium or channel of communication	渠道 qú dào 
irritable; irascible; impetuous	急躁 jí zào 
is bound to (happen)	势必 shì bì 
Islamic; Muslim; halal (of food); clean; pure	清真 qīng zhēn 
isolate; isolated	孤立 gū lì 
it goes without saying; it is self-evident	不言而喻 bù yán ér yù 
it's just perfect; it's just right	恰到好处 qià dào hǎo chù 
jade	玉 yù 
jeer; mockery; scoff; sneer; make fun of; laugh at (derogatory)	嘲笑 cháo xiào 
jet-black; dark	乌黑 wū hēi 
jewelry; head ornament;	首饰 shǒu shì 
judgment (by a court of law)	判决 pàn jué 
judgment; to referee; umpire; judge; referee; CL:个,位[wei4] ,名[ming2]	裁判 cái pàn 
judicial; (administration of) justice	司法 sī fǎ 
just as in the past (idiom); as before; continuing as always	一如既往 yī rú jì wǎng 
just; fair; equitable	公正 gōng zhèng 
justice; fairness; public highway	公道 gōng dào 
justice; righteous; righteousness	正义 zhèng yì 
keen; sharp; acute	敏锐 mǐn ruì 
kindly; benevolent (often of older person)	慈祥 cí xiáng 
kindly; nice; amiable	和蔼 hé ǎi 
kneel	跪 guì 
knee	膝盖 xī gài 
knotty; troublesome; bothersome	伤脑筋 shāng nǎo jīn 
knowledge gained; CL:个	心得 xīn dé 
laboratory test; chemical experiment; assay	化验 huà yàn 
lack; incomplete	贫乏 pín fá 
lady; madam; Mrs.; CL:位[wei4]	夫人 fū ren 
lair; nest; den; hideout;	巢穴 cháo xué 
lake	湖泊 hú pō 
lament; with a tinge of emotion or regret	感慨 gǎn kǎi 
lame	瘸 qué 
lane; alley	巷 xiàng 
Lantern festival; the final event of the Spring festival 春春节, on 15th of first month of the lunar calendar	元宵节 yuán xiāo jié 
lantern	灯笼 dēng lóng 
lapse; mistake; to make a mistake; fault; service fault (in volleyball, tennis etc)	失误 shī wù 
lasting; enduring; persistent; permanent; protracted; endurance; persistence; to last long	持久 chí jiǔ 
lateral side; side; aspect; profile	侧面 cè miàn 
law and order; public security	治安 zhì ān 
law case; legal case; judicial case; CL:宗[zong1] ,桩[zhuang1] ,起[qi3]	案件 àn jiàn 
lawsuit	诉讼 sù sòng 
layman; amateur	外行 wài háng 
lead; command; head	率领 shuài lǐng 
leader; CL:个,位[wei4] ,名[ming2]	领袖 lǐng xiù 
leading scholar of his time; magnate	泰斗 tài dǒu 
leaflet; flier; pamphlet	传单 chuán dān 
leather; CL:张[zhang1]	皮革 pí gé 
(leave or be a) legacy; left over; hand down (to next generation)	遗留 yí liú 
legal person; corporation; see also 自然自然人[zi4 ran2 ren2]	法人 fǎ rén 
lenient; tolerant; indulgent; charitable; to forgive;	宽容 kuān róng 
level; even; smooth; flat	平坦 píng tǎn 
lever; pry bar; crowbar; financial leverage	杠杆 gàng gǎn 
lifelong; all one's life; marriage	终身 zhōng shēn 
life	性命 xìng mìng 
limit; extreme boundary	极限 jí xiàn 
limit	局限 jú xiàn 
line of sight	视线 shì xiàn 
(line of) thought; thinking	思维 sī wéi 
lip; CL:片[pian4]	嘴唇 zuǐ chún 
liquid	液体 yè tǐ 
lit. actual location; the scene (of the incident); on-the-spot	现场 xiàn chǎng 
lit. crow and peacock make no sound; absolute silence (idiom); not a single voice can be heard; absolute silence;	鸦雀无声 yā què wú shēng 
lit. draw legs on a snake (idiom); fig. to ruin the effect by adding sth superfluous; to overdo it	画蛇添足 huà shé tiān zú 
literature and art	文艺 wén yì 
lit. I dare not (accept the honor); fig. I don't deserve your praise; you flatter me	不敢当 bù gǎn dāng 
lit. new bud; fig. new and original	新颖 xīn yǐng 
lit. on brocade, add flowers (idiom); to decorate sth already perfect; gilding the lily;	锦上添花 jǐn shàng tiān huā 
lit. proper behavior is based on reciprocity (idiom); fig. to return politeness for politeness;	礼尚往来 lǐ shàng wǎng lái 
lit. thousand ways, a hundred plans (idiom); by every possible means	千方百计 qiān fāng bǎi jì 
lit. warp and weft in weaving; vertically and horizontal; length and breadth; criss-crossed; able to move unhindered; abbr. for 合縱連合纵连横[He2 zong4 Lian2 heng2] , School of Diplomacy during the Warring States Period (475 - 221 BC)	纵横 zòng héng 
live broadcast (not recorded); direct internet broadcasting	直播 zhí bō 
local conditions and customs (idiom)	风土人情 fēng tǔ rén qíng 
local flavor; local style	风味 fēng wèi 
location; place	场所 chǎng suǒ 
locomotive; motorized; power-driven; adaptable; flexible (use, treatment, timing etc)	机动 jī dòng 
lofty quality; mettle; spirit	气概 qì gài 
logistics	后勤 hòu qín 
lonely; solitary	孤独 gū dú 
looking for employment; getting a job; to start a career	就业 jiù yè 
look; style; appearance; approximation; about; CL:个	模样 mú yàng 
lord; nobility; nobleman; noblewoman; aristocrat; aristocracy	贵族 guì zú 
lottery ticket	彩票 cǎi piào 
loud and clear; resounding	响亮 xiǎng liàng 
luckily; by a fluke;	侥幸 jiǎo xìng 
lucky; auspicious; propitious	吉祥 jí xiáng 
lung; CL:个	肺 fèi 
lush	茂盛 mào shèng 
luster; splendor; radiance; brilliance	光彩 guāng cǎi 
luxuriant growth (idiom); flourishing; thriving	欣欣向荣 xīn xīn xiàng róng 
luxurious; extravagant; wasteful	奢侈 shē chǐ 
machine; machinery; mechanical	机械 jī xiè 
macro-; macroscopic; holistic	宏观 hóng guān 
magical; mystical; miraculous	神奇 shén qí 
magic	魔术 mó shù 
magnetic tape; CL:盘[pan2] ,盒[he2]	磁带 cí dài 
magnificence; magnificent; majestic; glorious	壮丽 zhuàng lì 
main point; essential	要点 yào diǎn 
mainstay; pillar; prop; backbone	支柱 zhī zhù 
main stream (of a river); fig. the essential point; main viewpoint of a matter	主流 zhǔ liú 
majestic; sublime	崇高 chóng gāo 
(make an) exception	例外 lì wài 
make the decision; take charge of; back up; support; be host	做主 zuò zhǔ 
malady; evil; malpractice; drawback; disadvantage	弊病 bì bìng 
male and female	雌雄 cí xióng 
malfunction; breakdown; defect; shortcoming; fault; failure; impediment; error; bug (in software)	故障 gù zhàng 
malpractice; abuse; corrupt practice	弊端 bì duān 
man's world; the world	人间 rén jiān 
(manufacturing, production etc) costs	成本 chéng běn 
marginal notes; annotation; to annotate; to add comments to text	注释 zhù shì 
mark; indication; sign; indicator	迹象 jì xiàng 
marsh; swamp; wetlands; glade	沼泽 zhǎo zé 
martial arts chivalry (Chinese literary, theatrical and cinema genre); knight-errant	武侠 wǔ xiá 
massage	按摩 àn mó 
mass; multitude; the masses	群众 qún zhòng 
matchless	无比 wú bǐ 
(material) welfare; well-being	福利 fú lì 
(mathematical) operation	运算 yùn suàn 
matter; item	事项 shì xiàng 
meaning; content; essential properties implied or reflected by a notion; intention; connotation; self-possessed	内涵 nèi hán 
meaning (implicit in a phrase); implied meaning; hidden meaning; hint; connotation	含义 hán yì 
meat, fish; strong-smelling vegetable (garlic etc); non-vegetarian food (meat, fish, spicy food etc); vulgar; obscene;	荤 hūn 
mechanism; structure; organization; agency; institution; CL:所[suo3]	机构 jī gòu 
media; medium	媒介 méi jiè 
mediocre; indifferent; commonplace	平庸 píng yōng 
melody; rhythm	旋律 xuán lv4 
member	成员 chéng yuán 
membrane; film	膜 mó 
memorandum; aide-memoire; memorandum book	备忘录 bèi wàng lù 
memory; recall	记性 jì xing 
merciless; ruthless; cruel; mean	残忍 cán rěn 
metabolism (biology); the new replaces the old (idiom)	新陈代谢 xīn chén dài xiè 
meteorological feature; CL:个; meteorology; atmosphere or scene	气象 qì xiàng 
microphone	话筒 huà tǒng 
micro-; sub-atomic	微观 wēi guān 
might; awe-inspiring authority; impressive	威风 wēi fēng 
might; formidable power	威力 wēi lì 
milestone	里程碑 lǐ chéng bēi 
(Military) admiral; (chess) to check; to embarrass	将军 jiāng jūn 
military campaign	战役 zhàn yì 
(military) rank; level; grade	级别 jí bié 
millimeter	毫米 háo mǐ 
minerals;	矿产 kuàng chǎn 
minister (of a monarchy)	大臣 dà chén 
minutes; written summary of a meeting	纪要 jì yào 
minute; tiny; negligible; insignificant	渺小 miǎo xiǎo 
miserable; tragic	悲惨 bēi cǎn 
misgivings; apprehensions	顾虑 gù lv4 
missing; lost; unaccounted for	失踪 shī zōng 
mission (diplomatic or other); set task	使命 shǐ mìng 
mobilize; arouse; CL:次[ci4] ,个	动员 dòng yuán 
(modal particle to express that something is obvious)	嘛 ma 
model; fine example	模范 mó fàn 
modeling; mold-making; model or mold; molding	造型 zào xíng 
model; mould; matrix; pattern	模型 mó xíng 
model; typical case; archetype; typical; representative	典型 diǎn xíng 
mode; method	模式 mó shì 
moderate (policy etc)	温和 wēn hé 
moist; humid; to moisten; to provide moisture; comfortably off;	滋润 zī rùn 
moment; momentary; in a flash;	瞬间 shùn jiān 
momentum; manner; energy; look of great force or imposing manner; powerful	气势 qì shì 
momentum	声势 shēng shì 
money given to children as new year present	压岁钱 yā suì qián 
moral character	品德 pǐn dé 
more and more emerge; innumerable succession; breeding like flies (idiom)	层出不穷 céng chū bù qióng 
more or less; roughly; approximately	大致 dà zhì 
moreover; besides; in addition; furthermore	况且 kuàng qiě 
motor; locomotive; motive; motivation; intention	动机 dòng jī 
motto; maxim	座右铭 zuò yòu míng 
mountain range; CL:条[tiao2]	山脉 shān mài 
mourning; memorial (service etc)	追悼 zhuī dào 
must; to need to; to be sure to	务必 wù bì 
name; term of address; title	称号 chēng hào 
nanny; housekeeper	保姆 bǎo mǔ 
narrow; tight; narrow minded; lacking in experience	狭隘 xiá ài 
narrow	狭窄 xiá zhǎi 
nasal mucus; snivel	鼻涕 bí tì 
national defense	国防 guó fáng 
native language; mother language	母语 mǔ yǔ 
natural gas	天然气 tiān rán qì 
natural harbor; bay serving as harbor	港湾 gǎng wān 
nausea; to feel sick; disgust; nauseating	恶心 ě xin 
navigation	导航 dǎo háng 
nearby; in a close neighborhood	就近 jiù jìn 
need not; (contraction of 不 and 用)	甭 béng 
negligible; insignificant	微不足道 wēi bù zú dào 
nerve	神经 shén jīng 
nest; pit or hollow on the human body; lair; den; place; to harbor or shelter; to hold in check; to bend; classifier for litters and broods	窝 wō 
neutral	中立 zhōng lì 
nick; jag; gap; shortfall	缺口 quē kǒu 
nimble; quick; shrewd	敏捷 mǐn jié 
nobleman; person of noble character;	君子 jūn zǐ 
nobly; lofty	高尚 gāo shàng 
noisy; clamorous	嘈杂 cáo zá 
nook; corner	角落 jiǎo luò 
norm; index; target	指标 zhǐ biāo 
norm; standard; criterion	准则 zhǔn zé 
norm; standard; specification; regulation; rule; within the rules; to fix rules; to regulate; to specify	规范 guī fàn 
notarization; notarized; acknowledgement	公证 gōng zhèng 
(not) even; yet; still;	尚且 shàng qiě 
not in the least; none whatsoever; completely without	毫无 háo wú 
not just in name only, but also in reality (idiom)	名副其实 míng fù qí shí 
not one thread loose (idiom); strictly according to the rules; meticulous; not one hair out of place	一丝不苟 yì sī bù gǒu 
not stint; not spare; not hesitate (to do sth); not scruple (to do sth)	不惜 bù xī 
numb; insensitive; apathetic	麻木 má mù 
nurturing (i.e. assimilate some branch of culture); seeped in	熏陶 xūn táo 
oar; paddle	桨 jiǎng 
objective; aim; goal	宗旨 zōng zhǐ 
oblivion	埋没 mái mò 
obvious at a glance (idiom)	一目了然 yí mù liǎo rán 
obviously; plainly; undoubtedly; definitely	明明 míng míng 
occasionally; from time to time	时而 shí ér 
odor; scent	气味 qì wèi 
(of a cheque etc) to cash; to honor a commitment	兑现 duì xiàn 
(of a government, etc.) prestige and public reliance	威信 wēi xìn 
(of alcohol) to ferment; (of a crisis) to be brewing; to mull over (an issue); to hold exploratory discussions	酝酿 yùn niàng 
(of an area) rich in resources; (of a person) gifted or able (idiom)	得天独厚 dé tiān dú hòu 
(of cooking) to boil for a long time; to endure; to suffer	熬 áo 
official business	公务 gōng wù 
official; (by the) government	官方 guān fāng 
off season; slow business season; (see also 旺季)	淡季 dàn jì 
often; frequently	时常 shí cháng 
oh; ah	哦 ò 
oh alas; hey!; hi! (loanword)	嗨 hāi 
oil paints; lacquer; to paint; CL:层[ceng2]	油漆 yóu qī 
oil; petroleum	石油 shí yóu 
old-fashioned	陈旧 chén jiù 
omen; prognosis (in medicine)	预兆 yù zhào 
one move, two gains (idiom); two birds with one stone	一举两得 yì jǔ liǎng dé 
on end; in a row; in succession	接连 jiē lián 
one's appearance; one's aspect; looks; features	容貌 róng mào 
one's bosom (the seat of emotions); breast; broad-minded and open; to think about; to cherish	胸怀 xiōng huái 
oneself; I (humble form used in speeches); myself; in person; personal	本人 běn rén 
one's native place; place of ancestry; registered birthplace	籍贯 jí guàn 
one's thoughts; mind; intention; willingness to accept new ideas; baseless suspicions	心眼儿 xīn yǎn r 
only; just (i.e. it is only that...); all except; unique	唯独 wéi dú 
only; nothing else	无非 wú fēi 
on the eve of; to be about to; to be on the verge of	即将 jí jiāng 
on the other hand...; conversely...	反之 fǎn zhī 
on the verge of; close to	濒临 bīn lín 
openly; publicly; undisguised	公然 gōng rán 
opinion; view; understanding	见解 jiàn jiě 
opportunity; favorable circumstance; stroke of luck	机遇 jī yù 
opportunity to live; to reprieve from death; life force; vitality	生机 shēng jī 
oppressive (of weather); heavy; depressed; not happy	沉闷 chén mèn 
oral cavity	口腔 kǒu qiāng 
oral; verbal	口头 kǒu tóu 
orange (fruit, color)	橙 chéng 
orbit; railway or tram line; fig. conventional way of thinking	轨道 guǐ dào 
order; command; instruction	指令 zhǐ lìng 
organism; living creature; life form; biological; CL:个	生物 shēng wù 
organ (part of body tissue); apparatus	器官 qì guān 
originally; at first; at the outset	起初 qǐ chū 
origin; root (cause)	根源 gēn yuán 
origin; to originate; to come from	起源 qǐ yuán 
orthodox school; fig. traditional; old school; authentic; genuine;	正宗 zhèng zōng 
other; other people; him(her, them); I	人家 rén jia 
outer space	太空 tài kōng 
outer surface; outside; honor; reputation; face (as in 'losing face'); self-respect; feelings; (medicinal) powder	面子 miàn zi 
outlook; prospect; to look ahead; to look forward to	展望 zhǎn wàng 
outstanding; distinguished; remarkable; prominent; illustrious	杰出 jié chū 
outstanding; notable; remarkable	显著 xiǎn zhù 
outward-looking; extrovert; extroverted (personality); export-oriented (economy)	外向 wài xiàng 
oval; ellipse; elliptic	椭圆 tuǒ yuán 
overall situation	全局 quán jú 
overbearing; tyranny; (of liquor, medicine etc) strong; potent; the Way of the Hegemon, abbr. of 霸王之道; despotic rule; rule by might; evil as opposed to the Way of the King 王道;	霸道 bà dào 
overpass; flyover	立交桥 lì jiāo qiáo 
overseas Chinese; CL:个,位[wei4]	华侨 huá qiáo 
overthrow	推翻 tuī fān 
oxygen	氧气 yǎng qì 
pace; (measured) step; march	步伐 bù fá 
package; pack	包装 bāo zhuāng 
pad; cushion; mat	垫 diàn 
pagoda; tower; minaret; stupa (abbr. loanword from Sanskrit tapo); CL:座[zuo4]	塔 tǎ 
palace; CL:座[zuo4]	宫殿 gōng diàn 
pale; wan	苍白 cāng bái 
paper money; a bill (e.g. 100 yuan); CL:张[zhang1] ,扎[za1]	钞票 chāo piào 
paradise; heaven	天堂 tiān táng 
parallel; of equal rank; simultaneous	平行 píng xíng 
paralysis; palsy; numbness; to benumb	麻痹 má bì 
paralysis	瘫痪 tān huàn 
part; local	局部 jú bù 
partner; companion; mate	伴侣 bàn lv3 
party; association; club; society; surname Dang; CL:个	党 dǎng 
passion; fervor; enthusiasm; strong emotion	激情 jī qíng 
passive (not taking initiative)	被动 bèi dòng 
past events; former happenings	往事 wǎng shì 
patent	专利 zhuān lì 
patient; sufferer	患者 huàn zhě 
pattern; style; design; CL:种[zhong3]	款式 kuǎn shì 
pause	停顿 tíng dùn 
pavilion	亭子 tíng zi 
pay a New Year call; wish sb a Happy New Year	拜年 bài nián 
pay a visit; call on	拜访 bài fǎng 
peaceful relations; harmonious	和睦 hé mù 
peaceful; tranquil; calm; composed	安宁 ān níng 
peak; summit; height	高峰 gāo fēng 
pearl	珍珠 zhēn zhū 
perception; consciousness	知觉 zhī jué 
period; cycle	周期 zhōu qī 
periphery; rim	周边 zhōu biān 
perish; ruin; destroy	毁灭 huǐ miè 
perpendicular; vertical	垂直 chuí zhí 
perseverance; willpower	毅力 yì lì 
persistent; stubborn	固执 gù zhi 
personality; integrity; dignity	人格 rén gé 
personal strength; one's special ability or strong points	特长 tè cháng 
person; figure; public figure	人士 rén shì 
persons involved or implicated; party (to an affair)	当事人 dāng shì rén 
petal; CL:片[pian4];	花瓣 huā bàn 
physical resonance; sympathetic response to sth	共鸣 gòng míng 
physiology	生理 shēng lǐ 
picky; fussy	挑剔 tiāo ti 
pigeon; dove; various birds of the species Columbidae	鸽子 gē zi 
pillow	枕头 zhěn tou 
pill	丸 wán 
pitfall; snare; trap;	陷阱 xiàn jǐng 
pit; to defraud	坑 kēng 
plain and simple; unadorned; simple living; not frivolous	朴素 pǔ sù 
plain; simple; guileless; down-to-earth; sincere and honest	朴实 pǔ shí 
plait; braid; pigtail; a mistake or shortcoming that may be exploited by an opponent; handle; CL:根[gen1] ,条[tiao2]	辫子 biàn zi 
plane (flat surface); print media	平面 píng miàn 
plan; program	规划 guī huà 
play the part of; act	扮演 bàn yǎn 
pleasing to the eye; beautiful; artistic	美观 měi guān 
pleasure of heavenly agreement (idiom); family love and joy; domestic bliss	天伦之乐 tiān lún zhī lè 
plentiful; rich; plump; well-rounded	丰满 fēng mǎn 
plight; unfavorable situation	处境 chǔ jìng 
plot; circumstances	情节 qíng jié 
plot; conspiracy	阴谋 yīn móu 
pocket; bag; to wrap up or hold in a bag; to move in a circle; to canvas or solicit; to take responsibility for; to disclose in detail; combat armor (old)	兜 dōu 
poem for singing; tune; music; CL:支[zhi1]	曲子 qǔ zi 
policy; CL:个	政策 zhèng cè 
policy; guidelines; CL:个	方针 fāng zhēn 
(political, economic etc) affairs; work	事务 shì wù 
(politically) conservative; to guard; to keep	保守 bǎo shǒu 
popular; hot; in vogue	热门 rè mén 
popular; to popularize; universal; ubiquitous; pervasive	普及 pǔ jí 
porridge (of rice or millet)	粥 zhōu 
port; harbor	港口 gǎng kǒu 
portrait	肖像 xiào xiàng 
position; front	阵地 zhèn dì 
position in a ranking of names	名次 míng cì 
position; place	部位 bù wèi 
position; standpoint; CL:个	立场 lì chǎng 
positive and negative	正负 zhèng fù 
post; announcement	公告 gōng gào 
posterity; later periods; later ages; later generations	后代 hòu dài 
posting on a bulletin board; notice; bulletin; to announce	布告 bù gào 
post; office; position	职位 zhí wèi 
post; position; job; duties	职务 zhí wù 
potable water (water with low salt content); fresh water	淡水 dàn shuǐ 
potential; capacity	潜力 qián lì 
pottery and porcelain; ceramics	陶瓷 táo cí 
pound (unit of weight, about 454 grams); platform balance;	磅 bàng 
power; (ability to) influence	势力 shì li 
power; motion; propulsion; force	动力 dòng lì 
practical; down-to-earth; realistic; firmly based; steadfast; to have peace of mind; free from anxiety	踏实 tā shi 
practical; workable; to implement; to carry out; to decide	落实 luò shí 
precious	珍贵 zhēn guì 
precipitous	陡峭 dǒu qiào 
preface; introductory remarks; preamble; prelude	序言 xù yán 
prefecture; state (e.g. of US); province (old); administrative division (old)	州 zhōu 
prejudice	偏见 piān jiàn 
premise; precondition; prerequisite	前提 qián tí 
preparations; to get ready for sth	筹备 chóu bèi 
prerequisites; rules that must be known before starting sth	须知 xū zhī 
pressing; urgent	紧迫 jǐn pò 
prestige; distinction; reputation; trust	信誉 xìn yù 
prestige	威望 wēi wàng 
prevention and cure	防治 fáng zhì 
price; cost; consideration (in share dealing)	代价 dài jià 
principle; theory	原理 yuán lǐ 
priority	优先 yōu xiān 
prison	监狱 jiān yù 
private; personal; secretly; without explicit approval	私自 sī zì 
procession	行列 háng liè 
proficient	精通 jīng tōng 
profit; gain	盈利 yíng lì 
profound; abstruse; recondite; profoundly	深奥 shēn ào 
profound friendship	深情厚谊 shēn qíng hòu yì 
profound mystery	奥秘 ào mì 
program; guiding principle	纲领 gāng lǐng 
promise; prospects; future	出息 chū xi 
(pron) everyone; Ladies and Gentlemen; Sirs	诸位 zhū wèi 
property; assets	资产 zī chǎn 
property; real estate; property management;	物业 wù yè 
proportion; specific gravity	比重 bǐ zhòng 
proposal; suggestion; to propose; to suggest	提议 tí yì 
propriety; appropriate behavior; proper speech or action; within the norms	分寸 fēn cun 
pros and cons; advantages and disadvantages; gains and losses	利害 lì hài 
prose; essay	散文 sǎn wén 
prosperous; thriving; to prosper; to flourish	兴旺 xīng wàng 
prosperous	昌盛 chāng shèng 
protective screen	屏障 píng zhàng 
protein	蛋白质 dàn bái zhì 
protest	抗议 kàng yì 
provide assistance; aid	协助 xié zhù 
provided that; supposing that; if;	倘若 tǎng ruò 
provincial capital	省会 shěng huì 
publication	刊物 kān wù 
publicly known (to be); accepted (as)	公认 gōng rèn 
public opinion	舆论 yú lùn 
public relations	公关 gōng guān 
Public Security Bureau	公安局 gōng ān jú 
punishment; penalty; to punish	惩罚 chéng fá 
pure; clean and honest; to purify	纯洁 chún jié 
purely	纯粹 chún cuì 
put an end to	杜绝 dù jué 
put emphasis on; to stress; to emphasize	着重 zhuó zhòng 
puzzled; bewildered	纳闷儿 nà mèn r 
qigong, a system of deep breathing exercises	气功 qì gōng 
quality	品质 pǐn zhì 
quarter (finance, publishing, schools etc); season (sports); period of three months	季度 jì dù 
quick-witted; tact; witty; resourceful	机智 jī zhì 
quiet	寂静 jì jìng 
race; competition; CL:个	竞赛 jìng sài 
race; ethnicity	种族 zhǒng zú 
radar (loanword)	雷达 léi dá 
radiance; glory; brilliant; magnificent	光辉 guāng huī 
radiation	辐射 fú shè 
radio; CL:台[tai2]	收音机 shōu yīn jī 
ranks; troops; CL:个	队伍 duì wu 
rapid; sudden	急剧 jí jù 
rare and commendable; estimable	难能可贵 nán néng kě guì 
rare; precious and uncommon	珍稀 zhēn xī 
rare; rarely seen	罕见 hǎn jiàn 
rays of light; brilliant rays; radiance	光芒 guāng máng 
(reach) an understanding	谅解 liàng jiě 
ready-made; readily available	现成 xiàn chéng 
really isn't	并非 bìng fēi 
reason; cause	缘故 yuán gù 
reasoning; speculative; inference	推理 tuī lǐ 
reason; intellect; rationality	理智 lǐ zhì 
reason; sense	情理 qíng lǐ 
recently; lately	近来 jìn lái 
receptacle; vessel	容器 róng qì 
recite; repeat from memory	背诵 bèi sòng 
reconciled; smooth	熨 yù 
red clouds	霞 xiá 
refined; educate; cultured; intellectual; polite; gentle	斯文 sī wen 
refreshed; rejuvenated; frank and straightforward	爽快 shuǎng kuài 
regeneration through one's own effort (idiom); self-reliance	自力更生 zì lì gēng shēng 
regime; (wield) political power	政权 zhèng quán 
regular; according to standards	正规 zhèng guī 
regular and thorough (idiom); methodically arranged	有条不紊 yǒu tiáo bù wěn 
regularly; at regular intervals	定期 dìng qī 
religion	宗教 zōng jiào 
reluctant to leave; to hate to have to go; to recall fondly	留恋 liú liàn 
remedy	补救 bǔ jiù 
remember with concern; worry about	惦记 diàn jì 
remorse; repentance	悔恨 huǐ hèn 
remote control	遥控 yáo kòng 
remote; desolate; far from the city	偏僻 piān pì 
remuneration; reward	报酬 bào chou 
repeatedly; time and again	屡次 lv3 cì 
republic	共和国 gòng hé guó 
repulsive; vile; hateful; abominable	可恶 kě wù 
reputation; fame	声誉 shēng yù 
request sb to do sth; please!	拜托 bài tuō 
requirement; demand (economics)	需求 xū qiú 
rescue	抢救 qiǎng jiù 
residence; tenement	住宅 zhù zhái 
resident; inhabitant;	居民 jū mín 
respond to; answer; CL:个	响应 xiǎng yìng 
restoration	修复 xiū fù 
reverse side of sth; opposite side of some topic; the other side	反面 fǎn miàn 
revolution; revolutionary (politics); CL:次[ci4]	革命 gé mìng 
reward (as encouragement)	奖励 jiǎng lì 
reward; prize; an award	奖赏 jiǎng shǎng 
rhyming couplet; pair of lines of verse written vertically down the sides of a doorway; CL:幅[fu2]	对联 duì lián 
rhythm; tempo; musical pulse; cadence; beat	节奏 jié zòu 
rice crops	稻谷 dào gǔ 
rich; substantial; enrich; substantiate	充实 chōng shí 
rich; sumptuous	丰盛 fēng shèng 
riddle; conundrum	谜语 mí yǔ 
right and wrong; quarrel	是非 shì fēi 
roar of laughter (onomatopoeia); hubbub; to roar (as a crowd)	哄 hōng 
roar or howl of an animal; bellow of rage	吼 hǒu 
robust; strong	健全 jiàn quán 
rock and roll (music); to shake and boil	摇滚 yáo gǔn 
rocket; CL:枚[mei2]	火箭 huǒ jiàn 
rock	岩石 yán shí 
rogue; hoodlum; gangster; immoral behavior	流氓 liú máng 
rotten; decayed; decadent; degenerate	腐朽 fǔ xiǔ 
rough draft; material contributing to a final document	稿件 gǎo jiàn 
round segment; segment (of annelid worms); connection; link; sector; annular ring	环节 huán jié 
ruins	废墟 fèi xū 
rule; regulation	规章 guī zhāng 
rules; regulations; constitution; statute; articles of association (of company); articles of incorporation; charter (of a corporation); by-laws	章程 zhāng chéng 
rumble; noise; static	噪音 zào yīn 
rumor	谣言 yáo yán 
rush about; be busy running about	奔波 bēn bō 
salary; wage	薪水 xīn shuǐ 
salute	敬礼 jìng lǐ 
sample; specimen	样品 yàng pǐn 
satisfactory	圆满 yuán mǎn 
satisfied with what one has (idiom)	知足常乐 zhī zú cháng lè 
saturation	饱和 bǎo hé 
(saying) meticulous planning and careful accounting	精打细算 jīng dǎ xì suàn 
(saying) the gains do not make up for the losses	得不偿失 dé bù cháng shī 
(saying) to sum it up...	归根到底 guī gēn dào dǐ 
scar	疤 bā 
scatter; disperse; distribute	分散 fēn sàn 
scene; occasion	场面 chǎng miàn 
scene; view; sight; landscape; to be well-regarded; to be well-off; grand (topolect); impressive (topolect)	风光 fēng guāng 
screen (TV, computer or movie);	屏幕 píng mù 
script for play, opera, movie etc; screenplay	剧本 jù běn 
seal up	密封 mì fēng 
secondary; auxiliary; deputy; assistant; vice-; abbr. for 副副词 adverb; classifier for pairs	副 fù 
second place (in a sports contest); runner-up	亚军 yà jūn 
secretary; clerk; CL:个	书记 shū ji 
secret; classified (information)	机密 jī mì 
secrete	分泌 fēn mì 
secrets; something one hopes to conceal	隐私 yǐn sī 
section; fragment; segment;	片断 piàn duàn 
seed; CL:颗[ke1] ,粒[li4]	种子 zhǒng zi 
seeking instant benefit (idiom); shortsighted vision, looking only for fast return	急功近利 jí gōng jìn lì 
seldom; rare; hard to come by	难得 nán dé 
senior (in terms of depth of accumulated experience); deeply qualified	资深 zī shēn 
sensation; stir	轰动 hōng dòng 
sense of smell	嗅觉 xiù jué 
sensible; wise; judicious; sagacious;	明智 míng zhì 
sepulcher; tomb	坟墓 fén mù 
sequence; order	次序 cì xù 
serene	安详 ān xiáng 
series	系列 xì liè 
serious	郑重 zhèng zhòng 
setback; reverse; check; defeat; frustration; disappointment; to frustrate; to discourage; to set sb back; to blunt; to subdue	挫折 cuò zhé 
severe; strict	严厉 yán lì 
sex appeal; eroticism; sexuality; sexy	性感 xìng gǎn 
shape; form; pattern; morphology	形态 xíng tài 
shareholder; stockholder	股东 gǔ dōng 
sharp (e.g. knife blade); incisive; to the point	锋利 fēng lì 
sharp; intense; penetrating; pointed; acute (illness)	尖锐 jiān ruì 
sharp pointed end; the tip; the cusp; tip-top; most advanced and sophisticated; highest peak; the best	尖端 jiān duān 
sheet (bed); CL:条[tiao2] ,件[jian4] ,张[zhang1] ,床[chuang2]	床单 chuáng dān 
shell; conch; cowry; mother of pearl; hard outer skin; alternative reading bei4 qiao4, mostly written	贝壳 bèi ké 
shift in the trend of events; plot shift in a book; twists and turns	转折 zhuǎn zhé 
shine; illuminate	照耀 zhào yào 
shipping; boats	船舶 chuán bó 
shore; seaside	海滨 hǎi bīn 
short in time; fleeting; brief	短促 duǎn cù 
short period of time; a moment	片刻 piàn kè 
sight; vision; view; gaze; look	目光 mù guāng 
sign; mark; symbol; to mark up	标记 biāo jì 
silly; stupid	愚蠢 yú chǔn 
similar; analogous	类似 lèi sì 
similar to; appearing to be	犹如 yóu rú 
simple and crude (of a room or building)	简陋 jiǎn lòu 
simplified Chinese character, as opposed to traditional Chinese character 繁体字[fan2 ti3 zi4]	简体字 jiǎn tǐ zì 
simplify	简化 jiǎn huà 
sincere; cordial	诚挚 chéng zhì 
sincere; sincerity	真挚 zhēn zhì 
single sail, gentle wind (idiom); plain sailing; to go smoothly	一帆风顺 yì fān fēng shùn 
sing the praises of; extol; eulogize	歌颂 gē sòng 
situation; existing state of affairs	事态 shì tài 
situation; occasion	场合 chǎng hé 
situation; state (of affairs)	局势 jú shì 
skill; technique	技巧 jì qiǎo 
slag (in mining or smelting); dregs	渣 zhā 
slander; libel	诽谤 fěi bàng 
slander	污蔑 wū miè 
slave	奴隶 nú lì 
slope; CL:个	坡 pō 
slow and patient; chronic (disease); slow to take effect (e.g. a slow poison)	慢性 màn xìng 
slow in one's reactions; sluggish (in movement or thought);	迟钝 chí dùn 
slow; sluggish	迟缓 chí huǎn 
smart; clever; sensitive; keen; quick; sharp	灵敏 líng mǐn 
smash; smashed; to fail; to get it wrong	砸 zá 
smoke from kitchen chimneys;	炊烟 chuī yān 
so as not to; so as to avoid	免得 miǎn de 
social niceties; social interaction; a dinner party	应酬 yìng chou 
socket; outlet;	插座 chā zuò 
so far; up to now; still (not)	迄今为止 qì jīn wéi zhǐ 
soil	土壤 tǔ rǎng 
solid	固体 gù tǐ 
so that; so as to; in order to	以便 yǐ biàn 
soul; spirit	灵魂 líng hún 
sound of activity or people talking; news of activity	动静 dòng jìng 
source (of information etc); origin	来源 lái yuán 
sovereignty	主权 zhǔ quán 
space flight	航天 háng tiān 
(space) satellite; CL:颗[ke1]	卫星 wèi xīng 
spacious and well-lit; open and clear; to open out (onto a wider vista); optimistic; cheerful; carefree; easy-going; open-minded	开朗 kāi lǎng 
spacious; wide	宽敞 kuān chang 
speakers or speaker (electronic); acoustics; sound field (in a room or theater)	音响 yīn xiǎng 
specially; intentionally	特意 tè yì 
special-purpose trip	专程 zhuān chéng 
special; specific; designated; particular	特定 tè dìng 
special topic	专题 zhuān tí 
specialty; special knowledge or ability	专长 zhuān cháng 
specimen; sample; the root cause and symptoms of a disease	标本 biāo běn 
spectacular; magnificent sight	壮观 zhuàng guān 
speculation; to conjecture; to surmise; to speculate	推测 tuī cè 
speech; expression of opinion; public opinion	言论 yán lùn 
spinning and weaving	纺织 fǎng zhī 
spirit; boldness; positive outlook; imposing attitude	气魄 qì pò 
splash	溅 jiàn 
splendid; glorious	辉煌 huī huáng 
spontaneous	自发 zì fā 
spot; colored patch; stripe; spotted; striped; variegated;	斑 bān 
sprout; germ of a plant	萌芽 méng yá 
(spy) intelligence; information-gathering	情报 qíng bào 
spy	间谍 jiàn dié 
staff officer; to give advice	参谋 cān móu 
stagnation; at a standstill; bogged down	停滞 tíng zhì 
stalk; stem; CL:条[tiao2]	茎 jīng 
standard; norm; specification	规格 guī gé 
stark; stiff	僵硬 jiāng yìng 
State Council (PRC); State Department (USA)	国务院 guó wù yuàn 
stately	庄严 zhuāng yán 
statement; declaration; CL:项[xiang4] ,份[fen4]	声明 shēng míng 
statistics; to count; to add up	统计 tǒng jì 
steady; calm and collected; not nervous	沉着 chén zhuó 
steamship; CL:艘[sou1]	轮船 lún chuán 
steelyard; Roman balance; CL:台[tai2]	秤 chèng 
still (remaining); to remain (the same); yet	仍旧 réng jiù 
stingy; mean; miserly	吝啬 lìn sè 
stirring up trouble; to invite disaster	惹祸 rě huò 
stockpile; to store; to stockpile; storage	储存 chǔ cún 
stop up; close up; hard to get to; out of the way; inaccessible; unenlightened; blocking	闭塞 bì sè 
storm; violent commotion; fig. crisis (e.g. revolution, uprising, financial crisis etc)	风暴 fēng bào 
stove	炉灶 lú zào 
strategic decision; decision-making; policy decision; to determine policy	决策 jué cè 
strategy	战略 zhàn lvè 
strength	实力 shí lì 
strictly prohibit	严禁 yán jìn 
strict; tight (organization, surveillance etc)	严密 yán mì 
striving to be first and fearing to be last (idiom); outdoing one another	争先恐后 zhēng xiān kǒng hòu 
strong and solid; rich (resources)	雄厚 xióng hòu 
strong; solid; sturdy; firm; practical	扎实 zhā shi 
structure; pattern; layout	格局 gé jú 
stubborn; obstinate; unbending;	倔强 jué jiàng 
stubborn; obstinate	顽固 wán gù 
stuffing; filling, e.g. in 包子[bao3 zi5] or 饺子[jiao3 zi5]	馅儿 xiàn r 
style of work; way; style	作风 zuò fēng 
subject matter	题材 tí cái 
subject	科目 kē mù 
submit an expense account; apply for reimbursement; write-off; wipe out	报销 bào xiāo 
subordinate; underling	下属 xià shǔ 
subsidiary; auxiliary; attached; affiliated; subordinate; subordinating	附属 fù shǔ 
substance; essence	实质 shí zhì 
substandard products; defective; seconds	次品 cì pǐn 
successive generations; successive dynasties; past dynasties	历代 lì dài 
successive years; over many years	连年 lián nián 
sufficient to...; so much so that; so that	足以 zú yǐ 
suitable; appropriate	适宜 shì yí 
sullen; depressed; melancholy; dejected	忧郁 yōu yù 
summary; abstract	摘要 zhāi yào 
sum	总和 zǒng hé 
sunny and cloudless	晴朗 qíng lǎng 
sunset; the setting sun	夕阳 xī yáng 
superabundant; to teem with; to produce in abundance; to abound in	盛产 shèng chǎn 
superior; superiority	优越 yōu yuè 
superstition	迷信 mí xìn 
supply does not meet demand	供不应求 gōng bù yìng qiú 
survival of the fittest	优胜劣汰 yōu shèng liè tài 
suspense in a movie, play etc; concern for sb's welfare	悬念 xuán niàn 
suspicion; (be) suspected (of)	嫌疑 xián yí 
swelling or lump on skin; pimple; knot; preoccupation; problem	疙瘩 gē da 
symbol; mark; sign	符号 fú hào 
symmetry; symmetrical	对称 duì chèn 
symptom (of an illness)	症状 zhèng zhuàng 
system of enfeoffment; feudalism; feudal; feudalistic	封建 fēng jiàn 
system; setup; CL:个	体系 tǐ xì 
taboo; to avoid as taboo; to abstain from	忌讳 jì huì 
tactics; to be tactful	策略 cè lvè 
tactics	战术 zhàn shù 
tailor; dressmaker	裁缝 cái feng 
take a step	迈 mài 
take office; assume a post	就职 jiù zhí 
take office	上任 shàng rèn 
talent; gift; genius; talented; gifted	天才 tiān cái 
tall and straight	挺拔 tǐng bá 
tangible benefit; material advantages; advantageous (deal); substantial (discount)	实惠 shí huì 
task; problem; issue	课题 kè tí 
taste; flavor; feeling	滋味 zī wèi 
tasty; to taste good	可口 kě kǒu 
teacher-training; pedagogical; normal (school, e.g. Beijing Normal University)	师范 shī fàn 
technique; trick; skill	手法 shǒu fǎ 
temperament; personality traits; manners	气质 qì zhí 
temperate zone	温带 wēn dài 
temple; monastery; shrine	寺庙 sì miào 
temporarily; the time being; for the moment; provisional; tentatively	姑且 gū qiě 
tenacious; hard to defeat	顽强 wán qiáng 
tent; CL:顶[ding3] ,座[zuo4]	帐篷 zhàng peng 
tents; classifier for houses	幢 zhuàng 
terrain; topography relief	地势 dì shì 
terrible; frightful; frightening; terror; terrorist	恐怖 kǒng bù 
territory	领土 lǐng tǔ 
that's all; nothing more	而已 ér yǐ 
the daily life of a family	家常 jiā cháng 
The Dragon Boat Festival (the 5th day of the 5th lunar month)	端午节 duān wǔ jié 
the end; end point; finishing line (in a race); destination; terminus; CL:个	终点 zhōng diǎn 
the four limbs of the body	四肢 sì zhī 
the most important; of chief importance	首要 shǒu yào 
the North Pole; the Arctic Pole; the north magnetic pole	北极 běi jí 
theory; doctrine	学说 xué shuō 
the outside world; external	外界 wài jiè 
the present age; the contemporary era	当代 dāng dài 
there is no harm in; might as well	不妨 bù fáng 
the stream flows without stopping (idiom); unending flow	川流不息 chuān liú bù xī 
the traditional Chinese calendar; the lunar calendar	农历 nóng lì 
the truth about sth; the actual facts	真相 zhēn xiàng 
thief; wily; deceitful; evil; extremely; disagreeably	贼 zéi 
think deeply; ponder	思索 sī suǒ 
think of; long for; miss	思念 sī niàn 
third in a race; bronze medalist	季军 jì jūn 
third in order (III); third of 10 heavenly stems 十天干; letter 'C' or roman 'III' in list 'A, B, C', or 'I, II, III' etc; propyl	丙 bǐng 
thorn; splinter; to stab; to pierce; to prick	刺 cì 
three-dimensional; solid; stereoscopic	立体 lì tǐ 
throat; larynx	喉咙 hóu lóng 
tide; current; trend	潮流 cháo liú 
time; era; period of time	时光 shí guāng 
time limit; deadline; allotted time	期限 qī xiàn 
timid; cowardly	胆怯 dǎn qiè 
tip of branch	梢 shāo 
tire; pneumatic tire	轮胎 lún tāi 
title; heading; headline; caption; subject	标题 biāo tí 
to abolish; to abrogate; to repeal	废除 fèi chú 
to accept (a bit reluctantly); to put up with;	将就 jiāng jiù 
to accept; to adopt (ideas)	采纳 cǎi nà 
to accompany; to follow; to occur together with; attendant	伴随 bàn suí 
to accord; to give; to show (respect)	给予 jǐ yǔ 
to accumulate; to amass; to hoard; to save	攒 zǎn 
to act for oneself; autonomous	自主 zì zhǔ 
to act in a way that defeats one's purpose (idiom);	南辕北辙 nán yuán běi zhé 
to act jointly; to form a partnership	合伙 hé huǒ 
to act on behalf of sb in a responsible position; to act as an agent or proxy; surrogate	代理 dài lǐ 
to add hail to snow (idiom); one disaster on top of another; to make things worse in a bad situation	雪上加霜 xuě shàng jiā shuāng 
to adjourn; to delay; to defer; adjournment; procrastination	拖延 tuō yán 
to adjust; to balance; to make up a medical prescription	调剂 tiáo jì 
to adjust; to regulate; to harmonize; to reconcile (accountancy etc)	调节 tiáo jié 
to administer; to have jurisdiction (over)	管辖 guǎn xiá 
to admire; to look up to; to respect sb greatly	钦佩 qīn pèi 
to advocate; to initiate; to propose; to be a proponent of (an idea or school of thought)	倡导 chàng dǎo 
to affix a seal (to sth)	盖章 gài zhāng 
to age; to deteriorate with age; old and weak	衰老 shuāi lǎo 
to agitate; to arouse; to instigate; to encite	鼓动 gǔ dòng 
to aim (a weapon at a target); fig. to aim (for a higher standard);	瞄准 miáo zhǔn 
to allocate; to provide; to outfit with	配备 pèi bèi 
to allow; to permit	许可 xǔ kě 
to answer; to reply; Reply to: (in email header)	答复 dá fù 
to anticipate; to expect; to reckon ahead	意料 yì liào 
to appear; to emerge; to present (a certain appearance); demonstrate	呈现 chéng xiàn 
to appoint and nominate	任命 rèn mìng 
to appoint; to assign; to indicate clearly and with certainty; designated	指定 zhǐ dìng 
to appraise; to identify; to evaluate	鉴定 jiàn dìng 
to approve; approval; acknowledgment; OK	认可 rèn kě 
to arouse; to excite	激发 jī fā 
to arrest; to apprehend; an arrest	逮捕 dài bǔ 
to ask (a question) in reply; to answer a question with a question; rhetorical question	反问 fǎn wèn 
to ask; to demand;	索取 suǒ qǔ 
to assault; to pounce; to rush at sth; to throw oneself on	扑 pū 
to assign; to entrust (a task); to give; to bestow	赋予 fù yǔ 
to assist by the arm; to mix; to mix; to support; to sustain	搀 chān 
to assist; to aid; supplementary; auxiliary; subsidiary	辅助 fǔ zhù 
to associate with something in thinking; abbr. for 聯想集联想集团[Lian2 xiang3 Ji2 tuan2]	联想 lián xiǎng 
to assure; to guarantee; to take care of; to safeguard; certainly; surely	保管 bǎo guǎn 
to attack; to accuse; to charge; an attack (terrorist or military)	攻击 gōng jī 
to attack; to assault; to go on the offensive; attack; assault; offense (sports)	进攻 jìn gōng 
to attempt; to try	试图 shì tú 
to attempt vainly; a vain attempt	妄想 wàng xiǎng 
to awaken; to come to realize; awakened to the truth; the truth dawns upon one; scales fall from the eyes; to become aware	觉醒 jué xǐng 
to award; to confer	授予 shòu yǔ 
to bake; to heat by fire	烘 hōng 
to ban; to prohibit (publications, customs etc); to outlaw; to suppress (violators)	取缔 qǔ dì 
to bask in the light; fig. to benefit from association with sb or sth; reflected glory	沾光 zhān guāng 
to be amazed; to be surprised; to wonder	惊奇 jīng qí 
to bear; hardships	吃苦 chī kǔ 
to bear; to endure	忍受 rěn shòu 
to bear; to give birth; to grow; to rear; to bring up (children)	生育 shēng yù 
to beat up; to break to pieces	揍 zòu 
to beat up; to come to blows; battery (law)	殴打 ōu dǎ 
to be born	诞生 dàn shēng 
to become exhilarated (idiom); in high spirits; full of zest	兴致勃勃 xìng zhì bó bó 
to become invalid; to cancel; to delete; to nullify	作废 zuò fèi 
to be convinced; to accept	服气 fú qì 
to be convinced; to be sure; to firmly believe; to be positive that; definite news	确信 què xìn 
to be dedicated to one's work; to respect one's work;	敬业 jìng yè 
to be destroyed; to become extinct; to perish; to die out; to destroy; to exterminate	灭亡 miè wáng 
to be disgusted with; to dislike; bad reaction; antipathy	反感 fǎn gǎn 
(to be done) by (a certain date); lasting (a certain time)	为期 wéi qī 
to be eager for; to long for; to look forward to	巴不得 bā bù dé 
to be fascinated; to be captivated	着迷 zháo mí 
to begin an undertaking; to start a major task; to initiate; to venture; venture	创业 chuàng yè 
to be good at; to be expert in	擅长 shàn cháng 
to be gratified	欣慰 xīn wèi 
to be infatuated with; to be drunk with; to be enchanted with; to revel in	陶醉 táo zuì 
to be in flood; to overflow (the banks); to inundate; to spread unchecked	泛滥 fàn làn 
to be in vogue; to be prevalent	盛行 shèng xíng 
to be jealous; to envy; to hate	嫉妒 jí dù 
to believe in (a religion); firm belief; conviction	信仰 xìn yǎng 
to belittle; to disparage; to play down; to demean; to degrade; to devalue	贬低 biǎn dī 
to be on the alert; vigilant; alert; on guard; to warn	警惕 jǐng tì 
to be oriented towards; orientation	导向 dǎo xiàng 
to be pregnant; to produce offspring; to nurture (a development, school of thought, artwork etc); fig. replete with (culture etc)	孕育 yùn yù 
to be published; to come out	问世 wèn shì 
to betray	背叛 bèi pàn 
to be willing to do sth; to be ready to do sth; to be happy to do sth; content; satisfied	乐意 lè yì 
to bind; to restrict; to tie; to commit; fetters	束缚 shù fù 
to bind; to tie; bundle; cluster; restraint	束 shù 
to bind	捆绑 kǔn bǎng 
to blame; to rebuke	责怪 zé guài 
to blockade; to seal off	封锁 fēng suǒ 
to block; to stop; blockage	堵塞 dǔ sè 
to bow	鞠躬 jū gōng 
to brag; to chat (dialect)	吹牛 chuī niú 
to brake (when driving); to stop; to switch off; to check (bad habits); a brake	刹车 shā chē 
to break away from; to cast off (old ideas etc); to get rid of; to break away (from); to break out (of); to free oneself from; to extricate oneself	摆脱 bǎi tuō 
to break in; to wear in	磨合 mó hé 
to break new ground (for agriculture); to open up (a new seam); to develop (border regions); fig. to open up (new horizons)	开拓 kāi tuò 
to break out; to erupt; to explode; to burst out	爆发 bào fā 
to break through; to make a breakthrough; to surmount or break the back of (a task etc); (of ball sports) to break through a defense	突破 tū pò 
to break; to snap; to suffer the loss of; to turn; to bend; to admire; to amount to; to discoun; to fold; turning stroke (in Chinese character); booklet	折 zhé 
to break up into components; to disintegrate; to collapse; to crumble	解体 jiě tǐ 
to break with both hands	掰 bāi 
to breathe deeply; to pant	喘气 chuǎn qì 
to breed; to reproduce; to propagate	繁殖 fán zhí 
to bribe; a bribe	贿赂 huì lù 
to bring back to life; to revive; resurrection	复活 fù huó 
to bring sth to sb (news etc)	捎 shāo 
to bring together; to make do in a bad situation; to just get by; to improvise; passable; not too bad	凑合 còu he 
to brook no delay; to demand immediate action	刻不容缓 kè bù róng huǎn 
to build; to construct	修建 xiū jiàn 
to bully	欺负 qī fu 
to burst out; to gush; to spurt	迸发 bèng fā 
to bury	埋葬 mái zàng 
to call on (sb to do sth); to appeal (to); an appeal	呼吁 hū yù 
to call out (a name etc); to shout;	呼唤 hū huàn 
to call; to appeal	号召 hào zhào 
to capture; to take	攻克 gōng kè 
to care about; to mind	在意 zài yì 
to carry a story; to publish (in a newspaper or magazine)	刊登 kān dēng 
to carry (esp. slung over the arm, shoulder or side)	挎 kuà 
to carry (on one's person); to support (old); Taiwan pr. xi1 dai4	携带 xié dài 
to carve; to engrave; carving	雕刻 diāo kè 
to cast (pour metal into a mold)	铸造 zhù zào 
to catch; to seize; to capture	捕捉 bǔ zhuō 
to cause sb's death; very; extremely; frightening; annoying	要命 yào mìng 
to cause; to result in	致使 zhì shǐ 
to check on receipt; an inventory of received goods; to verify and accept (a delivery)	验收 yàn shōu 
to check; to contain; to hold back; to keep within limits; to constrain; to restrain	遏制 è zhì 
to chew	咀嚼 jǔ jué 
to chip away at a task and not abandon it (idiom); to chisel away at sth; to persevere; unflagging efforts	锲而不舍 qiè ér bù shě 
to choke; to stifle; to restrain; to hold back; to hold in (urine); to hold (one's breath)	憋 biē 
to choose; to pick; to sort out; to pick up	拣 jiǎn 
to chop the nail and slice the iron (idiom); resolute and decisive; unhesitating; definitely; without any doubt	斩钉截铁 zhǎn dīng jié tiě 
to circulate	流通 liú tōng 
to clasp; to cup the hands; to hold up with both hands; to offer (esp. in cupped hands); to praise; to flatter	捧 pěng 
to climb; to pull oneself up; to clamber; to scale; fig. to forge ahead in the face of hardships and danger	攀登 pān dēng 
to collapse; to crumble; to fall apart	崩溃 bēng kuì 
to collapse; to disintegrate; to crumble	瓦解 wǎ jiě 
to collude with; to collaborate with; to gang up with	勾结 gōu jié 
to come out; to emerge	展现 zhǎn xiàn 
to comment on; to discuss; comment; commentary; CL:篇[pian1]	评论 píng lùn 
to commit an offense; to violate the law; excuse me! (formal); see also 得得罪[de2 zui5]	得罪 dé zuì 
to compel; to force	强迫 qiǎng pò 
to complain	埋怨 mán yuàn 
to complement one another (idiom)	相辅相成 xiāng fǔ xiāng chéng 
to complement; to make up for a deficiency	弥补 mí bǔ 
to complete a construction project	落成 luò chéng 
to complete a contract; to reach a deal	成交 chéng jiāo 
to compose; to constitute; compound; synthesis; mixture; synthetic	合成 hé chéng 
to compress; compression	压缩 yā suō 
to compromise; to reach terms; a compromise	妥协 tuǒ xié 
to conceal a fault; to gloss over	掩饰 yǎn shì 
to conceal; to hide (a taboo subject); to cover up the truth	隐瞒 yǐn mán 
to conceal; to hide behind; to cover up	掩盖 yǎn gài 
to conceal; to hide; covert; under cover	隐蔽 yǐn bì 
to concede; to give in; to yield; a concession	让步 ràng bù 
to concentrate one's attention (idiom)	聚精会神 jù jīng huì shén 
to conclude; to determine; to come to a judgment	断定 duàn dìng 
to condense; to coagulate; coacervation (i.e. form tiny droplets); aggregation; coherent	凝聚 níng jù 
to confirm (sth to be true); to verify	证实 zhèng shí 
to consecrate; to dedicate; to devote	奉献 fèng xiàn 
to consider; to deliberate; to fill up a cup to the brim	斟酌 zhēn zhuó 
to consign (goods); to check through (baggage)	托运 tuō yùn 
to consolidate; consolidation; to strengthen	巩固 gǒng gù 
to constrain or repress emotions; oppressive; stifling; depressing; repression	压抑 yā yì 
to consult a reference; to refer to (another document)	参照 cān zhào 
to consult; to discuss seriously; to negotiate; to confer; negotiations; consultations	磋商 cuō shāng 
to consult with; to talk things over; agreement	协商 xié shāng 
to continue the struggle (idiom); to persist; unremitting efforts	再接再厉 zài jiē zài lì 
to continue; to go on; to last	延续 yán xù 
to contract; to undertake (a job)	承包 chéng bāo 
to contrast; to compare; to place side by side for comparison (as parallel texts); to check	对照 duì zhào 
to control; to curb; to restrict; to impede; to pin down (enemy troops)	牵制 qiān zhì 
to control; to restrict; to moderate; to temper; moderation; sobriety; to administer;	节制 jié zhì 
to control; to supervise; to inspect	监督 jiān dū 
to cool off; cooling	冷却 lěng què 
to cooperate; partner	搭档 dā dàng 
to coordinate; to harmonize; negotiation	协调 xié tiáo 
to correct; to make a correction	更正 gēng zhèng 
to correct; to make right	纠正 jiū zhèng 
to correspond; a correspondence; corresponding; homologous; matching with sth; counterpart	对应 duì yìng 
to correspond; answering (one another); to agree (among the part); corresponding; relevant; appropriate; (modify) accordingly	相应 xiāng yìng 
to count numbers; to keep to one's word; to hold (i.e. to remain valid); to count (i.e. to be important)	算数 suàn shù 
to cover the whole (area); to be found throughout	遍布 biàn bù 
to cover	覆盖 fù gài 
to create; to produce; to write; creative work; creation; CL:个	创作 chuàng zuò 
to criticize; to find fault with; to denounce	指责 zhǐ zé 
to cross over (by ferry); transition; interim; caretaker (administration)	过渡 guò dù 
to cross; to intersect	交叉 jiāo chā 
to curb; to put a stop to; to stop; to check; to limit	制止 zhì zhǐ 
to cut short; to break off; to discontinue	中断 zhōng duàn 
to cut staff; to lay off employees	裁员 cái yuán 
to cut the ribbon (at a launching or opening ceremony)	剪彩 jiǎn cǎi 
to cut; to cut apart	割 gē 
to cycle; to circulate; circle; loop	循环 xún huán 
to damage; to injure	损坏 sǔn huài 
to dare to; to be brave enough to	勇于 yǒng yú 
to daydream; lost in thought	发呆 fā dāi 
to dazzle; dazzling	耀眼 yào yǎn 
to deceive; to cheat	欺骗 qī piàn 
to declare one's position; to say where one stands	表态 biǎo tài 
to decline; to fall; to drop; to falter; a decline; recession (in economics)	衰退 shuāi tuì 
to decorate; an ornament; to adorn; only for show	点缀 diǎn zhuì 
to deduce; to infer	演绎 yǎn yì 
to defend; to safeguard; to protect; to uphold; to maintain	维护 wéi hù 
to defend; to safeguard	保卫 bǎo wèi 
to defraud; to swindle; to blackmail	诈骗 zhà piàn 
to degenerate; to go bad; to deteriorate; metamorphosis	变质 biàn zhì 
to delay; to extend; to postpone; to defer	延期 yán qī 
to demonstrate (as a protest); a demonstration; a military show of force	示威 shì wēi 
to demonstrate; to show how to do sth; demonstration; a model example	示范 shì fàn 
to denounce; to condemn; to criticize; condemnation; criticism	谴责 qiǎn zé 
to depend on; to be dependent on	依赖 yī lài 
to deposit money; to save; savings	储蓄 chǔ xù 
to descend to	降临 jiàng lín 
to describe; to portray	描绘 miáo huì 
to despise; to disdain; to look down upon;	鄙视 bǐ shì 
to despise; to look down on;	藐视 miǎo shì 
to destroy (by melting or burning); to obliterate	销毁 xiāo huǐ 
to detain (a prisoner); to keep sb in custody	拘留 jū liú 
to detain; retention	滞留 zhì liú 
to develop; growth; development	发育 fā yù 
to develop; to evolve	演变 yǎn biàn 
to develop; to make full use of	发扬 fā yáng 
to differ; discrepancy between	相差 xiāng chà 
to differentiate; to distinguish	鉴别 jiàn bié 
to differentiate; to find differing aspects	区分 qū fēn 
to discipline sb; to punish; disciplinary action; to deal with (a matter); CL:个	处分 chǔ fèn 
to discriminate against; discrimination	歧视 qí shì 
to discuss	洽谈 qià tán 
to disdain as beneath contempt	不屑一顾 bú xiè yī gù 
to disinfect; to sterilize	消毒 xiāo dú 
to dislike; suspicion; resentment; enmity; abbr. for 嫌嫌犯[xian2 fan4] , criminal suspect	嫌 xián 
to display; to exhibit	陈列 chén liè 
to dispose; to deploy; deployment	部署 bù shǔ 
to dissect (an animal); to analyze; anatomy	解剖 jiě pōu 
to disseminate;	散布 sàn bù 
to distinguish; to differentiate; to resolve; to defend against an accusation; to exculpate	分辨 fēn biàn 
to distinguish; to discern	识别 shí bié 
to distort; to misrepresent	歪曲 wāi qū 
to disturb; to cause a commotion; to harass;	骚扰 sāo rǎo 
to disturb; to look for trouble; to stir up a row; to bother sb intentionally	捣乱 dǎo luàn 
to disturb; to perturb; to harass	扰乱 rǎo luàn 
to dither; to hesitate; to pace back and forth; by ext. to hover around; to linger	徘徊 pái huái 
to dive; to go under water; lurker (Internet slang for sb who reads forum posts but never replies)	潜水 qián shuǐ 
to divide	划分 huà fēn 
to dominate; to allocate	支配 zhī pèi 
to do one's utmost; with all one's might; at all costs; (to work or fight) as if one's life depends on it	拼命 pīn mìng 
to doubt; to distrust; unconvincing; to puzzle over; misgivings; suspicions	疑惑 yí huò 
to do with difficulty; to force sb to do sth; reluctant; barely enough	勉强 miǎn qiǎng 
to drag; to haul	拽 zhuài 
to drain; to drench; to drip; diseases of the bladder	淋 lín 
to draw close to	靠拢 kào lǒng 
to draw support from; with the help of	借助 jiè zhù 
to draw up; to draft; to formulate	拟定 nǐ dìng 
to drift about; to wander; to roam; nomadic; homeless; unsettled (e.g. population); vagrant	流浪 liú làng 
to drift apart; to become estranged; to alienate; estrangement;	疏远 shū yuǎn 
to drop; to fall; to tumble; Taiwan pr. die2	跌 diē 
to dry in the air	晾 liàng 
to dye; to catch (a disease); to acquire (bad habits etc); to contaminate; to add colour washes to a painting	染 rǎn 
to ease (tension); to alleviate; to moderate; to allay; to make more mild	缓和 huǎn hé 
to elaborate (on a theme); to expound (the classics); perfunctory; to skimp; to botch; to do sth half-heartedly or just for show; barely enough to get by	敷衍 fū yǎn 
to elect; election; CL:次[ci4] ,个	选举 xuǎn jǔ 
to eliminate; to get rid of; to remove	排除 pái chú 
to eliminate; to remove	消除 xiāo chú 
to embroider	绣 xiù 
to emerge in large numbers; to spring up; to emerge prominently	涌现 yǒng xiàn 
to empathize; to allow (for something); to show understanding; to appreciate	体谅 tǐ liàng 
to employ; to hire	雇佣 gù yōng 
to encourage; to urge; motivation; incentive	激励 jī lì 
to encourage	勉励 miǎn lì 
to endorse; to support	拥护 yōng hù 
to endure; to suffer; hardships; torments; a hard time; a nuisance	受罪 shòu zuì 
to enforce; enforcement; forcibly; compulsory	强制 qiáng zhì 
to enlarge; to magnify	放大 fàng dà 
to ensure; to guarantee; to safeguard	保障 bǎo zhàng 
to ensure; to guarantee	确保 què bǎo 
to entertain; to treat cordially	款待 kuǎn dài 
to entice; to lure; to induce; to attract	诱惑 yòu huò 
to entrap; to frame; to plant false evidence against sb	诬陷 wū xiàn 
to entrust; to trust; to commission	委托 wěi tuō 
to envelop; to shroud	笼罩 lǒng zhào 
to erase; to cover traces; to obliterate evidence; to expunge; to blot out; to suppress	抹杀 mǒ shā 
to erect; vertical; vertical stroke (in Chinese characters)	竖 shù 
to establish; to fix; to settle	奠定 diàn dìng 
to establish; to institute	确立 què lì 
to evade; to shun; to avoid	回避 huí bì 
to evaluate; to assess; assessment; evaluation	评估 píng gū 
to evaporate; evaporation	蒸发 zhēng fā 
to examine or inspect; self-criticism; review	检讨 jiǎn tǎo 
to examine; to check up on; to assess; to review; appraisal; review; evaluation	考核 kǎo hé 
to examine; to investigate; to censor out; censorship	审查 shěn chá 
to excavate; to dig; to unearth	挖掘 wā jué 
to excite; to raise up; to shrug; high; lofty; towering	耸 sǒng 
to exert (effort or pressure)	施加 shī jiā 
to exist; to survive	生存 shēng cún 
to expand	扩充 kuò chōng 
to expel; to deport; banishment	驱逐 qū zhú 
to expel	开除 kāi chú 
to explain; to justify; to defend (a point of view etc); to provide an explanation; to try to defend oneself	辩解 biàn jiě 
to exploit; exploitation	剥削 bō xuē 
to explore; to probe; commonly used in names of publications or documentaries	探索 tàn suǒ 
to expose; to reveal; to lay bare	暴露 bào lù 
to expose; to unmask; to ferret out; to disclose; disclosure	揭露 jiē lù 
to expound (a position); to elaborate (on a topic); to treat (a subject)	阐述 chǎn shù 
to express in words or writing; to make a speech (esp. short introduction, vote of thanks, afterword, funeral homily etc); to address (an audience); same as 致致词	致辞 zhì cí 
to express sympathy, greetings, consolation etc	慰问 wèi wèn 
to express; to reveal (one's thoughts or feelings)	流露 liú lù 
to extend; to spread	延伸 yán shēn 
to extend; to spread	蔓延 màn yán 
to extract (ore, minerals etc); to refine; to purify; to process	提炼 tí liàn 
to extract (ore or other resource from a mine); to exploit; to mine	开采 kāi cǎi 
to fail to live up (to expectations); unworthy (of trust); to let down; to betray (hopes); to disappoint	辜负 gū fù 
to fall; to drop; to weigh down	坠 zhuì 
to fasten; to button; button; buckle; knot; to arrest; to confiscate; to deduct (money); discount; to knock; to smash, spike or dunk (a ball); to cover (with a bowl etc); fig. to tag a label on sb;	扣 kòu 
to fawn on; to curry favor with; to make up to	巴结 bā jie 
to fear; to dread; foreboding	畏惧 wèi jù 
to feed (sb or some animal)	喂 wèi 
to feel about; to grope about; to fumble; to do things slowly	摸索 mō suo 
to feel sorry for a person over sth that should have happened	惋惜 wǎn xī 
to feign; to pretend to be; to pass oneself off as	冒充 mào chōng 
to fight a battle; to go to war	打仗 dǎ zhàng 
to fight; to battle; CL:场[chang2] ,次[ci4]	战斗 zhàn dòu 
to fight; to scuffle; to come to blows; CL:场[chang2]	打架 dǎ jià 
to file a lawsuit; to sue; to dispute	打官司 dǎ guān si 
to filter; filter	过滤 guò lv4 
to filter	筛选 shāi xuǎn 
to find; to detect; to discover	发觉 fā jué 
to finish; to end; to complete	完毕 wán bì 
to fire; to sack; to dismiss	解雇 jiě gù 
to fish out (from pocket); to scoop	掏 tāo 
to fish up; to dredge up	捞 lāo 
to flatter; to laud sb's accomplishments; adulation	吹捧 chuī pěng 
to flee; to scuttle; to exile or banish; to amend or edit	窜 cuàn 
to float; to hover; to drift (also fig., to lead a wandering life); to rove; showy; superficial	漂浮 piāo fú 
to follow sb's tracks; to tail; to shadow	跟踪 gēn zōng 
to follow; to abide by; to comply with; compliance	遵循 zūn xún 
to follow	跟随 gēn suí 
to force; to compel; to coerce	逼迫 bī pò 
to forecast; to anticipate; expectation	预料 yù liào 
to forge; to fake; to counterfeit	伪造 wěi zào 
to form a complete set; coherent	配套 pèi tào 
to foster; to bring up; to raise	抚养 fǔ yǎng 
to found; to establish; originate	创立 chuàng lì 
to frame (up); to make false charges against	陷害 xiàn hài 
to freeze (loan, wage, price etc)	冻结 dòng jié 
to freeze; to solidify; to congeal; fig. with rapt attention	凝固 níng gù 
to fulfill (one's obligations); to carry out (a task); to implement (an agreement); to perform	履行 lv3 xíng 
to furnish; to provide; supply (as in supply and demand)	供给 gōng jǐ 
to gamble	赌博 dǔ bó 
to gather; to collect; to harvest	采集 cǎi jí 
to gently caress and stroke; to pet; to fondle;	抚摸 fǔ mō 
to get angry; irritated; to annoy; to aggravate; annoying	恼火 nǎo huǒ 
together with; along with	连同 lián tóng 
to get into a habit; to become addicted	上瘾 shàng yǐn 
to get rich	发财 fā cái 
to get rid of; to remove; to exclude; to eliminate; to wipe out; to divide; except; not including	除 chú 
to get the desired outcome; to win favor by fawning on sb; to curry favor with; a fruitful outcome to reward one's labor;	讨好 tǎo hǎo 
to give a name to; to dub; to christen; to designate; named after; naming	命名 mìng míng 
to give thought (to others); to consider (other people's needs)	着想 zhuó xiǎng 
to give up halfway (idiom); leave sth unfinished	半途而废 bàn tú ér fèi 
to glitter; brilliant; splendid	灿烂 càn làn 
to gnaw; to nibble; to bite	啃 kěn 
to go bankrupt; to close down	倒闭 dǎo bì 
to go easy; unhurried; calm; Taiwan pr. [cong1 rong2];	从容 cóng róng 
to go hunting	打猎 dǎ liè 
to go the wrong way; to go against one-way traffic regulation;	逆行 nì xíng 
to govern; to administer; to manage; to control	治理 zhì lǐ 
to groan; to snort; to hum; to croon; humph!	哼 hēng 
to grow; to cultivate	栽培 zāi péi 
to grumble	啰唆 luō suo 
to guarantee; to vouch for	担保 dān bǎo 
to guard a pass; to check on sth	把关 bǎ guān 
to guard; to protect	守护 shǒu hù 
to guide; to lead; to conduct; introduction	引导 yǐn dǎo 
to guide; to lead	带领 dài lǐng 
to hack; to chop; to split open; see 噼劈啪, onomat. for crack, slap, clap, clatter etc	劈 pī 
to haggle; to bicker; to argue	计较 jì jiào 
to handle; to deal with; to cope; to get by with	对付 duì fu 
to handle; to take care of; to punish	处置 chǔ zhì 
to hand over; to explain; to make clear; to brief (sb); to account for; to justify oneself; to confess; to finish (colloquial)	交代 jiāo dài 
to have a contest with sb; to cross swords; to measure up against; to compete with; to haggle; to quibble	较量 jiào liàng 
to have an accident (plane crash, shipwreck, vehicle collision etc); to mess things up	失事 shī shì 
to have a reunion;	团圆 tuán yuán 
to have sb look after sb; to entrust the care of sb; to place (hope etc) on	寄托 jì tuō 
to have; to possess	拥有 yōng yǒu 
to hear (a case)	审理 shěn lǐ 
to heckle; rowdy jeering; to create a disturbance	起哄 qǐ hòng 
to heed; to pay attention to	理睬 lǐ cǎi 
to hesitate	迟疑 chí yí 
to hew; to cut down	砍伐 kǎn fá 
to hint; to indicate (an idea to sb)	示意 shì yì 
to hint; to suggest; suggestion; a hint	暗示 àn shì 
to hire; to recruit	招收 zhāo shōu 
to hit; to strike; to attack; to crack down on sth; a setback; a blow; percussion (music)	打击 dǎ jī 
to hit with hands or fists; to start work; to touch	动手 dòng shǒu 
to hoard; to collect; collection	收藏 shōu cáng 
to hold in store; to contain (untapped reserves etc)	蕴藏 yùn cáng 
to hold in the mouth	叼 diāo 
to hold on to; to cling to; to dig up; to rake; to push aside; to climb; to pull out; to strip off	扒 bā 
to hold or embrace in one's arms	搂 lǒu 
to hold; to contain; to accommodate; to tolerate (different opinions)	容纳 róng nà 
to hold; to contain; to ladle; pick up with a utensil	盛 chéng 
to honor; to cite (in dispatches); cite (in dispatches); commend	表彰 biǎo zhāng 
to hope for sth; to count on; hope	指望 zhǐ wàng 
to hum and haw (idiom); to mumble as if hiding sth; to speak and break off, then start again; to hold sth back;	吞吞吐吐 tūn tūn tǔ tǔ 
to imagine; to assume; to envisage; tentative plan; to have consideration for	设想 shè xiǎng 
to impart; to pass on; to teach	传授 chuán shòu 
to implement; to carry out; to put into practice	实行 shí xíng 
to implement; to carry out	实施 shí shī 
to implement; to put into practice; to carry out	贯彻 guàn chè 
to incite disharmony; to instigate	挑拨 tiǎo bō 
to incline; to lean; to slant; to slope; to tilt	倾斜 qīng xié 
to increase by degrees; in increasing order; incremental; progressive	递增 dì zēng 
to increase steadily; to grow with each passing day	与日俱增 yǔ rì jù zēng 
to infer; a deduction; a corollary; a reasoned conclusion	推论 tuī lùn 
to infringe on; to encroach on; to violate	侵犯 qīn fàn 
to inherit; to carry on; to succeed	继承 jì chéng 
to inlay; to embed; to set (e.g. a jewel in a ring); tiling; tesselation	镶嵌 xiāng qiàn 
to inspect and verify; experimental verification	验证 yàn zhèng 
to inspect; to examine; to test	检验 jiǎn yàn 
to inspect; to observe and study; on-the-spot investigation	考察 kǎo chá 
to instant-boil (mutton, beef, vegetables, etc.)	涮火锅 shuàn huǒ guō 
to instruct the young; to initiate; to awake sb from ignorance; to free sb from prejudice or superstition; primer; enlightened; the Enlightenment; Western learning from the late Qing dynasty;	启蒙 qǐ méng 
to insult; to humiliate; dishonor	侮辱 wǔ rǔ 
to intensify; to sharpen; to accelerate; to aggravate; to exacerbate; to embitter	加剧 jiā jù 
to interfere; obstruction	干扰 gān rǎo 
to interfere; to meddle; interference	干涉 gān shè 
to investigate and capture (a criminal); to ferret out; to hunt down and arrest	查获 chá huò 
to investigate; dialectical	辩证 biàn zhèng 
to investigate; to probe	探讨 tàn tǎo 
to invite bids;	招标 zhāo biāo 
to involve; to implicate	牵扯 qiān chě 
to involve; to touch upon (a topic)	涉及 shè jí 
to irrigate	灌溉 guàn gài 
to issue; to proclaim; to enact (laws, decrees etc)	颁布 bān bù 
to issue; to promulgate; to award	颁发 bān fā 
to join together; to combine	衔接 xián jiē 
to jump; to leap; to bound; to skip	跳跃 tiào yuè 
to keep as a souvenir; to recall fondly	留念 liú niàn 
to keep sth confidential; to maintain secrecy	保密 bǎo mì 
to keep; to maintain; to preserve	维持 wéi chí 
to kidnap; to abduct; to hijack; a kidnapping; abduction; staking	绑架 bǎng jià 
to knead; to massage; to rub	揉 róu 
to land; to come ashore; to make landfall (of typhoon etc); to log in	登陆 dēng lù 
to lead; to be in front	领先 lǐng xiān 
to lead; to manage	主导 zhǔ dǎo 
to leak (information); to divulge	泄露 xiè lù 
to leak (of information, liquid etc); to divulge	走漏 zǒu lòu 
to leak out; to divulge	透露 tòu lù 
to lean on; to prop on	拄 zhǔ 
to leap; to bounce; to hop; to jump	蹦 bèng 
to leap; to jump; eager; enthusiastically	踊跃 yǒng yuè 
to leap	飞跃 fēi yuè 
to levy (a fine); to impose (a tariff)	征收 zhēng shōu 
to liberate; to emancipate; liberation; refers to the Communists' victory over the Nationalists in 1949; CL:次[ci4]	解放 jiě fàng 
to lick; to lap	舔 tiǎn 
to lie on one's stomach	趴 pā 
to lift; to raise in height; to begin; upsurge; to set off (a campaign)	掀起 xiān qǐ 
to listen attentively	倾听 qīng tīng 
to load or unload; to transfer; to assemble and disassemble	装卸 zhuāng xiè 
to loathe; to despise; contempt	蔑视 miè shì 
to loath; to hate; disgusted with sth	厌恶 yàn wù 
to look back; to review	回顾 huí gù 
to look distracted; to stare blankly; distracted; blank; (coll.) unexpectedly	愣 lèng 
to look down at; to overlook	俯视 fǔ shì 
to look for	寻觅 xún mì 
to look in all directions (idiom); to glance around	东张西望 dōng zhāng xī wàng 
to look upon; to regard	看待 kàn dài 
to lose consciousness; to be in a coma; stupor; coma; stunned; disoriented	昏迷 hūn mí 
to lose face	丢人 diū rén 
to lose; lost	遗失 yí shī 
to lose; to forfeit	丧失 sàng shī 
to love and respect; love and respect	爱戴 ài dài 
to love dearly; the pain of love	心疼 xīn téng 
to love sth too much to part with it (idiom); to fondle admiringly	爱不释手 ài bù shì shǒu 
to maintain (that sth is true); to determine (a fact); determination (of an amount); of the firm opinion; to believe firmly; to set one's mind on; to identify with	认定 rèn dìng 
to make an exception	破例 pò lì 
to make every effort to; striving to do one's best;	力求 lì qiú 
to make headway; to make progress	进展 jìn zhǎn 
to make progress; to do better; fig. ambitious to improve oneself; to move forwards	上进 shàng jìn 
to make reprisals; to retaliate; revenge; retaliation	报复 bào fù 
to make trouble without reason (idiom); deliberately awkward; pointless provocation; willful trouble maker	无理取闹 wú lǐ qǔ nào 
to market; to sell	推销 tuī xiāo 
to meddle; to intervene; intervention	干预 gān yù 
to mediate; to bring parties to an agreement	调解 tiáo jiě 
to meet by chance; to come across; to fawn upon	逢 féng 
to meet; meeting; conference	会晤 huì wù 
to meet with; to encounter; (bitter) experience	遭遇 zāo yù 
to melt; to thaw; to dissolve; to blend into; to combine; to fuse	融化 róng huà 
to merge; to annex	合并 hé bìng 
to migrate; to move	迁徙 qiān xǐ 
to mistreat; to maltreat; to abuse; mistreatment; maltreatment	虐待 nvè dài 
to misunderstand; to misread; misunderstanding	误解 wù jiě 
to mix; to blend	混合 hùn hé 
to mix together (disparate substances); to mingle; a mix; to be tangled up with	夹杂 jiā zá 
to moan; to groan	呻吟 shēn yín 
to model; to mould; plastic (arts); flexible; to portray (in sculpture or in words)	塑造 sù zào 
to monitor; to oversee; to keep a close watch over; to spy on	监视 jiān shì 
to morally degenerate; to become depraved; a fall from grace; a fall into sin or depravity	堕落 duò luò 
to move up and down; to undulate; ups and downs	起伏 qǐ fú 
to narrow one's eyes; (Dialect) to nap; to take a nap	眯 mī 
to neglect sleep and forget about food (idiom); to skip one's sleep and meals; to be completely wrapped up in one's work;	废寝忘食 fèi qǐn wàng shí 
to neglect; to overlook; negligence; carelessness	疏忽 shū hu 
to neglect; to overlook; to ignore	忽略 hū lvè 
to negotiate; relating to	交涉 jiāo shè 
tone of voice; the way one speaks; manner of expression; tone	口气 kǒu qì 
tongue; enemy soldier captured for the purpose of extracting information; CL:个	舌头 shé tou 
to obey (an order); to comply; to defer	服从 fú cóng 
to obscure; to confuse; to mix up; to blur; to mislead	混淆 hùn xiáo 
to obstruct; to hinder; to block	阻碍 zǔ ài 
to occupy (a territory); to hold	占领 zhàn lǐng 
to occupy; to hold	占据 zhàn jù 
to offend; to violate; to go against	触犯 chù fàn 
to offend;	冒犯 mào fàn 
to offer for sale; to sell; to sell out or betray	出卖 chū mài 
too much; excessively	过于 guò yú 
to open (one's eyes) wide; to stare at; to glare at	瞪 dèng 
to open up; to set up; to start; to build	开辟 kāi pì 
to operate; to control; to rig; to manipulate	操纵 cāo zòng 
to oppose; to set sth against; to be antagonistic to; antithetical; relative opposite; opposing; diametrical	对立 duì lì 
to oppress; to repress; to constrict; oppression; stress (physics)	压迫 yā pò 
to order the arrest of sb as criminal; to list as wanted;	通缉 tōng jī 
to organize; to host (a conference or sports event)	主办 zhǔ bàn 
to outline a story; to make a preliminary sketch	构思 gòu sī 
to overlap; to superimpose; to telescope; to run together; to duplicate; one over another; superposition; an overlap; redundancy; reduplication (in Chinese grammar, e.g. 散散步[san4 san4 bu4] to have a stroll)	重叠 chóng dié 
to over-praise; to flatter	过奖 guò jiǎng 
to paint; to smear; to doodle	涂抹 tú mǒ 
to pair up; to match; to arrange in pairs; to add sth into a group	搭配 dā pèi 
to pan fry; to sauté	煎 jiān 
to parrot; to crib; to copy sb's action or words; to trail sb's footsteps; copy-cat	附和 fù hè 
to pass away; to die	逝世 shì shì 
to pass on; to convey; to communicate	转达 zhuǎn dá 
to pass on; to convey; to relay; to transmit; transmission	传达 chuán dá 
to pass through; to cross; to overcome	穿越 chuān yuè 
to patrol (police, army or navy)	巡逻 xún luó 
to pay attention to; to emphasize	注重 zhù zhòng 
to pay (taxes etc)	缴纳 jiǎo nà 
to peel with a knife; to pare; to cut (a ball at tennis etc);	削 xuē 
to perfect sth that is already outstanding (idiom); constantly improving	精益求精 jīng yì qiú jīng 
to permeate; to infiltrate; to pervade; osmosis	渗透 shèn tòu 
to persecute; persecution	迫害 pò hài 
to persecute; to torment	折磨 zhé mó 
to pervade; to fill the air; diffuse; everywhere present; about to inundate (water); permeated by (smoke); filled with (dust); to saturate (the air with fog, smoke etc)	弥漫 mí màn 
to pick (flowers); to pinch; to clutch; (slang) to fight	掐 qiā 
to pick up; to collate or arrange; ten (banker's anti-fraud numeral)	拾 shí 
to pile up; to heap; accumulation	堆积 duī jī 
to pinch (with one's fingers); to knead; to make up	捏 niē 
to pinch; wring	拧 níng 
to place; to put aside; to shelve	搁 gē 
to plant; to grow;	种植 zhòng zhí 
to play a musical instrument; to perform music	演奏 yǎn zòu 
to play truant; to cut classes	旷课 kuàng kè 
to play with; to engage in; to resort to; to dally with	玩弄 wán nòng 
to play with; to juggle	耍 shuǎ 
to plot; to scheme; to bring about; to engineer; planning; producer; planner	策划 cè huà 
to plunder; to rob; also written 略略夺	掠夺 lvè duó 
to point out; to indicate; to instruct; directives; instructions; CL:个	指示 zhǐ shì 
top priority job; matter of vital importance	当务之急 dāng wù zhī jí 
top quality; front ranking	一流 yī liú 
to practice fraud; to cheat; to engage in corrupt practices	作弊 zuò bì 
to prattle; to chatter; talkative; garrulous; to nag	唠叨 láo dao 
to predict; prophecy	预言 yù yán 
to press; to squeeze; to extract juice, oil etc by squeezing	压榨 yā zhà 
to prevent; to guard against; to take precautions	防止 fáng zhǐ 
to prick; to run or stick (a needle etc) into; jug (a classifier for liquids such as beer)	扎 zhā 
to probe; to take readings; to explore; exploration	探测 tàn cè 
to process; processing; working (of machinery)	加工 jiā gōng 
to proclaim; to make public or well known	宣扬 xuān yáng 
to procure (for an enterprise etc); to purchase	采购 cǎi gòu 
to promise; to undertake to do something; commitment	承诺 chéng nuò 
to promote to a higher job; to select for promotion	提拔 tí bá 
to promote to a higher position	晋升 jìn shēng 
to prompt; to present; to point out; to draw attention to sth; hint; brief; cue	提示 tí shì 
to prop up; to support; strut; brace	支撑 zhī chēng 
to prove a point; proof; to expound on; demonstrate or prove (through argument)	论证 lùn zhèng 
to provide assistance; to support; to back	支援 zhī yuán 
to provoke; provocation	挑衅 tiǎo xìn 
to publish; to issue (stocks, currency etc); to release; to distribute (a film)	发行 fā xíng 
to pull (an animal on a tether); to lead along; to hold hands	牵 qiān 
to pull back; to shrink; to contract	收缩 shōu suō 
to punish; punishment; sanctions (incl. economic)	制裁 zhì cái 
to push aside; to dial; to allocate; to set aside (money); to poke (the fire); to pluck (a string instrument); to turn round; classifier: group, batch;	拨 bō 
to put an end to; to annihilate; to cause to perish; to perish; annihilation (in quantum field theory)	消灭 xiāo miè 
to put in order; to arrange; to decorate; to fix up; to deploy	布置 bù zhì 
to put one's hand to it; to start out on a task; to set out	着手 zhuó shǒu 
to put on make-up	化妆 huà zhuāng 
to put up; to build (scaffolding); to hang (clothes on a pole); to connect; to join; to arrange in pairs; to match; to add; to throw in (resources); to take (boat, train)	搭 dā 
to put up with; to tolerate	容忍 róng rěn 
to puzzle; to confuse; to baffle	迷惑 mí huo 
to quote; to cite; to recommend; to appoint	引用 yǐn yòng 
to radiate; radioactive	放射 fàng shè 
to raise aloft with both hands	扛 gāng 
to raise animals	畜牧 xù mù 
to raise; to rear	饲养 sì yǎng 
to raise	翘 qiào 
to ravage; to ruin	摧残 cuī cán 
to reach (an agreement); to accomplish	达成 dá chéng 
to recognize; to identify	辨认 biàn rèn 
to recycle; to reclaim; to retrieve; to recover	回收 huí shōu 
to reflect; reflection (from a mirror etc); reflex (i.e. automatic reaction of organism)	反射 fǎn shè 
to refuse politely	谢绝 xiè jué 
to register; to login	登录 dēng lù 
to rehearse; rehearsal;	排练 pái liàn 
to reject; to exclude; to eliminate; to remove; to repel	排斥 pái chì 
to release; to issue; to announce; to distribute; also written 發发布[fa1 bu4]	发布 fā bù 
to release; to set free; to liberate (a prisoner); to discharge	释放 shì fàng 
to rely on sth (for support etc); to depend on	依靠 yī kào 
to rely on; to depend on	依托 yī tuō 
to remain; left over; surplus; remnant	残留 cán liú 
to remove; to sack; to get rid of; to relieve (sb of their duties); to free; to lift (an embargo); to rescind (an agreement)	解除 jiě chú 
to rent; to lease; to hire	租赁 zū lìn 
to repay; to reimburse	偿还 cháng huán 
to repay; to requite	报答 bào dá 
to repeal; to revoke; to undo (computing)	撤销 chè xiāo 
to replace the old with new; to renew; to renovate; to upgrade; to update; to regenerate	更新 gēng xīn 
to reply (to an accusation)	答辩 dá biàn 
to report sth to the police; to sound an alarm	报警 bào jǐng 
to report; to give an account of; to collect information and report back	汇报 huì bào 
to report (to the authorities); to declare (to customs)	申报 shēn bào 
to reside; to dwell; to live in a place; resident in	居住 jū zhù 
to resist; resistance	抵抗 dǐ kàng 
to resist; to boycott; to refuse (to cooperate); to reject; resistance; refusal	抵制 dǐ zhì 
to resist; to rebel	反抗 fǎn kàng 
to resolve; to decompose; to break down	分解 fēn jiě 
to restore to the original state; reduction (chemistry)	还原 huán yuán 
to restrain; to control; restraint; self-control;	克制 kè zhì 
to restrict; condition	制约 zhì yuē 
to restrict; to limit to; to constrain; restriction; constraint	约束 yuē shù 
to restrict; to restrain; constrained; awkward; ill at ease; uncomfortable; reticent	拘束 jū shù 
to retort; to refute	反驳 fǎn bó 
to retrieve; to redeem	挽回 wǎn huí 
to return sth; to revert	归还 guī huán 
to reveal; to display; to show; to exhibit sth	展示 zhǎn shì 
to revenge (oneself); to avenge	报仇 bào chóu 
to revere; high esteem	崇敬 chóng jìng 
to revere; to admire	瞻仰 zhān yǎng 
to reverse; to turn around (an undesirable situation)	扭转 niǔ zhuǎn 
to revive; rebirth	复兴 fù xīng 
to revive, to revitalize, to invigorate, to re-energize	振兴 zhèn xīng 
to ride; to mount; to make use of; to avail oneself of; to take advantage of; to multiply (mathematics); Buddhist sect or creed	乘 chéng 
to rob; looting	抢劫 qiāng jié 
to roll up	卷 juǎn 
to rotate; to revolve; to spin; to whirl	旋转 xuán zhuǎn 
to rot; to become gangrenous	腐烂 fǔ làn 
to rub or roll between the hands or fingers; to twist	搓 cuō 
to ruin; to corrupt; to undermine	败坏 bài huài 
to rule (a country); to govern; rule; regime	统治 tǒng zhì 
to run quickly; to travel quickly; to move fast; Mercedes-Benz, German car make	奔驰 bēn chí 
to rust; to grow rusty; to corrode; oxidization	生锈 shēng xiù 
to sacrifice oneself; to lay down one's life; to do sth at the expense of; beast slaughtered for sacrifice; sacrifice; CL:个	牺牲 xī shēng 
to sail; to fly; to navigate	航行 háng xíng 
to satisfy a craving; to get a kick out of sth; gratifying; immensely enjoyable; satisfying; fulfilling	过瘾 guò yǐn 
to save; to remedy; to rescue	挽救 wǎn jiù 
to sb's face; in sb's presence	当面 dāng miàn 
to scold in a loud voice; to yawn	呵 hē 
to screen; to shield; to cover; protection; cover; CL:面[mian4]	掩护 yǎn hù 
to seal; to close; to confine; to seal off; to close down; sealed; confined; closed; unreceptive	封闭 fēng bì 
to seek; to strive for	谋求 móu qiú 
to seek truth from facts (idiom); to be practical and realistic	实事求是 shí shì qiú shì 
to see what is right and act courageously (idiom, from Analects); to stand up bravely for the truth; acting heroically in a just cause	见义勇为 jiàn yì yǒng wéi 
to select the best	选拔 xuǎn bá 
to sell; to peddle; to traffic	贩卖 fàn mài 
to send back information; feedback	反馈 fǎn kuì 
to send (on a mission); to dispatch	派遣 pài qiǎn 
to separate oneself from; to break away from; diastasis (medicine); abscission; abjunction (botany)	脱离 tuō lí 
to separate; to isolate	隔离 gé lí 
to serve as; to act as; to play the role of	充当 chōng dāng 
to serve; to act as a valet	伺候 cì hòu 
to set off;	衬托 chèn tuō 
to set out on a journey	启程 qǐ chéng 
to settle a bill; to close an account	结算 jié suàn 
to settle (a dispute out of court); to reconcile; settlement; conciliation; to become reconciled	和解 hé jiě 
to settle; to precipitate (solid sediment out of a solution)	沉淀 chén diàn 
to set up; to establish	树立 shù lì 
to set up; to establish	设立 shè lì 
to set up; to install	设置 shè zhì 
to sever; to break off	断绝 duàn jué 
to shake; to jolt; to bump	颠簸 diān bǒ 
to shake; to vibrate; to shock; to stun; shocking; stunning; fig. mind-blowing;	震撼 zhèn hàn 
to shelter from; to keep out	遮挡 zhē dǎng 
to shield; to harbor; to cover up	包庇 bāo bì 
to shift; to divert or distract (attention etc); to change; to transform; metastasis (medicine)	转移 zhuǎn yí 
to shift; to move	挪 nuó 
to shock; to astonish	震惊 zhèn jīng 
to shoot (a projectile); to fire (a rocket); to launch; to emit (a particle); to discharge; emanation; emission	发射 fā shè 
to show an interest in; to get involved with	过问 guò wèn 
to show off; to flaunt;	炫耀 xuàn yào 
to show restraint; to repress (anger etc); to exercise patience	忍耐 rěn nài 
to shudder; to shiver; to shake; to tremble	颤抖 chàn dǒu 
to sigh or gasp in admiration; high praise	赞叹 zàn tàn 
to sigh; to heave a sigh	叹气 tàn qì 
to sign (an agreement)	签署 qiān shǔ 
to signify; to mean; to imply	意味着 yì wèi zhe 
to simplify; to reduce	精简 jīng jiǎn 
to sink into; to get caught up in; to land in (a predicament)	陷入 xiàn rù 
to size sb up; to take measure of; to suppose; to reckon	打量 dǎ liang 
to slaughter livestock; to govern or rule; to cheat customers; Imperial official in dynastic China	宰 zǎi 
to slight; to neglect	怠慢 dài màn 
to slip away; to escape in stealth; to skate	溜 liū 
to smuggle; to have an illicit affair	走私 zǒu sī 
to sneer	讥笑 jī xiào 
to sow seeds; sowing; seed	播种 bō zhòng 
to spare no effort (idiom); to do one's utmost	竭尽全力 jié jìn quán lì 
to speak frankly with assurance;	侃侃而谈 kǎn kǎn ér tán 
to speak in defense of; to argue in favor of; to defend; to plead	辩护 biàn hù 
to speculate (on financial markets); opportunistic; congenial; agreeable	投机 tóu jī 
to spend; to pay out; expense	支出 zhī chū 
to spiral; to circle; to go around; to hover; to orbit	盘旋 pán xuán 
to splash; to spill; rough and coarse; brutish	泼 pō 
to split up; to divide; to break up; fission	分裂 fēn liè 
to spoil things through excessive enthusiasm (idiom)	拔苗助长 bá miáo zhù zhǎng 
to spread out; vendor's stand;	摊 tān 
to spread; to extend; to pave; to lay	铺 pū 
to spread; to proliferate; to diffuse; spread; proliferation; diffusion	扩散 kuò sàn 
to spurn; to disdain;	唾弃 tuò qì 
to spur on; to urge on; to encourage sb (e.g. to make progress)	鞭策 biān cè 
to squander money; extravagant; prodigal; free and easy; agile	挥霍 huī huò 
to stand side by side; to be juxtaposed	并列 bìng liè 
to stand; to have a footing; to be established; to base oneself on	立足 lì zú 
to start; to launch; to unleash; to mobilize; to arouse	发动 fā dòng 
to station; to garrison (troops)	驻扎 zhù zhā 
to steal	盗窃 dào qiè 
to steep; to soak; to immerse	浸泡 jìn pào 
to step across; to stride over; to straddle; to span	跨 kuà 
to stir oneself up; to raise one's spirits; to inspire	振奋 zhèn fèn 
to stir; to agitate	搅拌 jiǎo bàn 
to stop burning; to go out (of fire); to die out; extinguished	熄灭 xī miè 
to stop; to close; to put a stop to sth; cut-off point; stopping point; deadline;	截止 jié zhǐ 
to stop; to obstruct	阻拦 zǔ lán 
to stop; to terminate (law)	终止 zhōng zhǐ 
to store up; reserves	储备 chǔ bèi 
to string together; to mix up; to conspire; to rove; bunch or cluster; string (computing); classifier for rows or strings	串 chuàn 
to struggle; struggling	挣扎 zhēng zhá 
to struggle; to wrestle	拼搏 pīn bó 
to study meticulously; to delve into	钻研 zuān yán 
to subdue; to check; to bring under control; (in former times) what one is allowed to wear depending on social status; uniform (army, party, school etc); livery (for company employees); CL:套[tao4]	制服 zhì fú 
to submerge; to drown; to flood; to drown out (also fig.)	淹没 yān mò 
to subsidize; subsidy; allowance	补贴 bǔ tiē 
to subsidize; to provide financial aid; subsidy	资助 zī zhù 
to such an extent as to; down to; up to	以致 yǐ zhì 
to suddenly realize; to suddenly see the light	恍然大悟 huǎng rán dà wù 
to suffer a calamity	遭殃 zāo yāng 
to suffer from; to endure; to tide over (a difficult period); to delay	挨 ái 
to suffer; to sustain (loss, misfortune)	遭受 zāo shòu 
to suggest; to initiate; proposal; initiative	倡议 chàng yì 
to sum up to; to total	共计 gòng jì 
to support; to assist; sponsor	赞助 zàn zhù 
to suppress; to inhibit; to stifle	压制 yā zhì 
to surge up violently (of ocean, river, lake etc); turbulent;	汹涌 xiōng yǒng 
to surpass; to exceed; to transcend	超越 chāo yuè 
to surrender; surrender	投降 tóu xiáng 
to surrender; to yield	屈服 qū fú 
to surround; to encircle; to hem in	包围 bāo wéi 
to survey; to measure; to gauge; to determine	测量 cè liáng 
to suspend; to hang; suspension (cable car)	悬挂 xuán guà 
to suspend; to hang up; to hang a person	吊 diào 
to sway; to shake; to wander about;	晃 huǎng 
to swear an oath (of office); to make a vow	宣誓 xuān shì 
to take a bath; to bathe; to immerse	沐浴 mù yù 
to take care of oneself	保重 bǎo zhòng 
to take care; to be careful	留神 liú shén 
to take care; to keep an eye on; to look after; to tell; to remind	关照 guān zhào 
to take effect; to go into effect	生效 shēng xiào 
to take good care of (or conserve) one's health; to keep in good repair; to maintain; maintenance	保养 bǎo yǎng 
to take leave	告辞 gào cí 
to take part in an election; to run for office	竞选 jìng xuǎn 
to take precautions; to guard against (emergency)	戒备 jiè bèi 
to take turns; order in series; time; a kind of; barbarians	番 fān 
totally	统统 tǒng tǒng 
to tap; knock	磕 kē 
to taste a small amount; to sample	品尝 pǐn cháng 
to tell lies	撒谎 sā huǎng 
to tell; to exhort; injunction	嘱咐 zhǔ fù 
to tell; to instruct; to command	吩咐 fēn fù 
to test; to put to the test	考验 kǎo yàn 
to think back over sth; to review; to revisit; to rethink; reflection; reassessment	反思 fǎn sī 
to think over; to ponder	琢磨 zhuó mó 
to think up every possible method (idiom); to devise ways and means; to try this, that and the other	想方设法 xiǎng fāng shè fǎ 
to thirst for; to long for	渴望 kě wàng 
to threaten; to menace	恐吓 kǒng hè 
to throw sth a long distance; to hurl	投掷 tóu zhì 
to throw; to cast; left-slanting downward brush stroke (calligraphy);	撇 piē 
to thwart; to obstruct (sth)	阻挠 zǔ náo 
to tidy up; to reorganize; to consolidate; to rectify	整顿 zhěng dùn 
to tire; tired	疲倦 pí juàn 
to toss from side to side (e.g. sleeplessly); to repeat sth over and over again; to torment sb; to play crazy	折腾 zhē teng 
to tour; sightseeing; tourism	观光 guān guāng 
to train; to breed	培育 péi yù 
to train; to educate; to bring up; to nurture; education; culture; upbringing; early conditioning	教养 jiào yǎng 
to trample	践踏 jiàn tà 
to transfer; to maneuver (troops etc)	调动 diào dòng 
to tread on; to step on	蹬 dēng 
to treat sb unfairly	亏待 kuī dài 
to tremble; to shiver; uncontrolled shaking of the body	哆嗦 duō suo 
to trust; to have confidence in; to have faith in; to rely on	信赖 xìn lài 
to try; to attempt; CL:次[ci4]	尝试 cháng shì 
to turn upside-down; to reverse; back-to-front; confused; deranged; crazy	颠倒 diān dǎo 
tough and durable; tenacious	坚韧 jiān rèn 
to understand; to comprehend; to grasp	领会 lǐng huì 
to understand; to comprehend	领悟 lǐng wù 
to undertake; to accept a contract	承办 chéng bàn 
to urge sb to complete a task	督促 dū cù 
to use fully; to put to use	施展 shī zhǎn 
to use other people's experience; to borrow from a source; to use as reference	借鉴 jiè jiàn 
to use up; to consume	消耗 xiāo hào 
to violate; to be contrary to	违背 wéi bèi 
to visit; to call on; to interview; CL:次[ci4]	访问 fǎng wèn 
to visit	探望 tàn wàng 
to vomit	呕吐 ǒu tù 
to vote; vote	投票 tóu piào 
to vow; to pledge; to swear	发誓 fā shì 
to wake up; to regain consciousness	苏醒 sū xǐng 
to warn repeatedly; to urge; to exhort again and again	叮嘱 dīng zhǔ 
to warn; to admonish	告诫 gào jiè 
to warn; to admonish	警告 jǐng gào 
to wash out; elimination (by selection); natural selection; to knock out (in a competition); to die out; to phase out	淘汰 táo tài 
to waste; to spend; to consume; to squander	耗费 hào fèi 
to waste; to wreck; to despoil; to abuse; to slander; to insult; to defile; to trample on	糟蹋 zāo tà 
to watch attentively; to fix attention on; to stare; to gaze; to follow; to shadow sb	盯 dīng 
to watch attentively; to gaze	注视 zhù shì 
to waver; swaying (of building in an earthquake)	摇摆 yáo bǎi 
to weaken	削弱 xuē ruò 
to weave; to knit; to plait; to braid; (fig.) to create (sth abstract, e.g. a dream, a lie etc);	编织 biān zhī 
to weep;	哭泣 kū qì 
to weigh; to consider; to assess; to balance; to trade-off	权衡 quán héng 
to whistle; to scream; to whiz	呼啸 hū xiào 
to wilt; to wither; wilted; withered; drained; enervated; exhausted;	枯萎 kū wěi 
to withdraw; to pull out; to retreat	撤退 chè tuì 
to withstand; to resist; to stand off; antagonism; confrontation	对抗 duì kàng 
to witness; to see at first hand; to see with one's own eyes	目睹 mù dǔ 
to wolf down one's food (idiom); to devour ravenously; to gorge oneself;	狼吞虎咽 láng tūn hǔ yàn 
to work a shift; on duty	值班 zhí bān 
to work for; to devote one's efforts to;	致力 zhì lì 
to work hard for sth; to resolve on improvement; determined not to fall short	争气 zhēng qì 
to work hard for; to do all one can; to contend strongly	力争 lì zhēng 
to work hard; to look after	操劳 cāo láo 
to work; to operate; to manipulate	操作 cāo zuò 
to work with a common purpose (idiom); to make concerted efforts; to pull together; to work as one	齐心协力 qí xīn xié lì 
to worship; adoration	崇拜 chóng bài 
to wrap; to pack; to ask for a doggy bag (at a restaurant)	打包 dǎ bāo 
to wrestle; to fight; to struggle	搏斗 bó dòu 
to write; literary work; book; article; writings; CL:部[bu4]	著作 zhù zuò 
to yearn for; to look forward to	向往 xiàng wǎng 
to yield; to adapt to; to accommodate to (sth)	迁就 qiān jiù 
toy; plaything; thing; act; trick (in a performance, stage show, acrobatics etc)	玩意儿 wán yì r 
track and field (athletics)	田径 tián jìng 
tracks; trail; footprint; trace; vestige	踪迹 zōng jì 
trademark; logo	商标 shāng biāo 
traditional Chinese character	繁体字 fán tǐ zì 
trail; clues; thread (of a story)	线索 xiàn suǒ 
transfer (technology, goods etc); conveyancing (property)	转让 zhuǎn ràng 
trap; snare; trick	圈套 quān tào 
treaty; pact; CL:个	条约 tiáo yuē 
tree trunk; stump (tree root); a plant; classifier for trees or plants; to involve others (in shady business)	株 zhū 
trend; tendency; orientation	倾向 qīng xiàng 
tributary (river)	支流 zhī liú 
troop arrangement; battle formation; line-up (of a sports team etc)	阵容 zhèn róng 
truth; CL:个	真理 zhēn lǐ 
tumor	肿瘤 zhǒng liú 
tunnel	隧道 suì dào 
turbid; muddy; dirty	混浊 hùn zhuó 
turnover (in cash or personnel); to have enough resources to cover a need	周转 zhōu zhuǎn 
twin; CL:对[dui4]	双胞胎 shuāng bāo tāi 
twisting; to twine; to wind; to pester; to bother	缠绕 chán rào 
ugly; repulsive	丑恶 chǒu è 
unavoidable; a bit too much; over the top (you exaggerate)	未免 wèi miǎn 
unavoidable	不免 bù miǎn 
unceasing torrent (idiom); talking non-stop; gabbling forty to the dozen	滔滔不绝 tāo tāo bù jué 
understood by everyone (idiom); well known; a household name	家喻户晓 jiā yù hù xiǎo 
undertaking; project; activity; (charitable, political or revolutionary) cause; publicly funded institution, enterprise or foundation; career; occupation; CL:个	事业 shì yè 
unexpectedly; to one's surprise	不料 bú liào 
unfamiliar; strange; out of practice; not accustomed	生疏 shēng shū 
unfathomable mystery (idiom); subtle and ineffable; unable to make head or tail of it; boring (e.g. movie)	莫名其妙 mò míng qí miào 
unimpeded; free-flowing; straight path; unclogged; move without obstruction	畅通 chàng tōng 
universe; cosmos	宇宙 yǔ zhòu 
unprecedented and never to be duplicated; the first and the last; unmatched; unique	空前绝后 kōng qián jué hòu 
unreasonable; shocking; outrageous	不像话 bú xiàng huà 
unrest (social or political); turmoil; upheaval; commotion	动荡 dòng dàng 
unusual; abnormal	反常 fǎn cháng 
unusual; unique	别致 bié zhì 
upper reaches; advanced position	上游 shàng yóu 
upright; regular; proper; correct	端正 duān zhèng 
upsurge; (tensions etc) run high	高涨 gāo zhǎng 
up to (a time); by (a time)	截至 jié zhì 
user; consumer; subscriber; customer	用户 yòng hù 
vague; ambiguous; equivocal; dubious	暧昧 ài mèi 
vague; faint; indistinct	隐约 yǐn yuē 
vanity	虚荣 xū róng 
vast and limitless (idiom); endless span of time; no vestige of a beginning, no prospect of an end	无穷无尽 wú qióng wú jìn 
vast; extensive	辽阔 liáo kuò 
vegetarian food; vegetables	素食 sù shí 
vehement; fervent; generous; giving; liberal	慷慨 kāng kǎi 
version; edition; release	版本 bǎn běn 
very long; endless	漫长 màn cháng 
very much; extremely; one ten thousandth part	万分 wàn fēn 
vestige; mark; trace	痕迹 hén jì 
veto; to overrule; to veto; to reject	否决 fǒu jué 
victory or defeat; the outcome of a battle	胜负 shèng fù 
video	视频 shì pín 
villa; CL:幢[zhuang4] ,座[zuo4]	别墅 bié shù 
village; township	乡镇 xiāng zhèn 
violence; (use) force; violent	暴力 bào lì 
violent; acute; severe; fierce	剧烈 jù liè 
vision; eyesight	视力 shì lì 
vision	眼光 yǎn guāng 
vitamin	维生素 wéi shēng sù 
volume; bulk; CL:个	体积 tǐ jī 
waiting	等候 děng hòu 
wantonly; without restraint (of enemy or malefactor); unbridled	大肆 dà sì 
warn; well; surname Jing; CL:口[kou3]	井 jǐng 
warp and woof; longitude and latitude; main points	经纬 jīng wěi 
warship; naval vessel	舰艇 jiàn tǐng 
water conservancy; irrigation works	水利 shuǐ lì 
waterfall	瀑布 pù bù 
wave; flutter; fly	飘扬 piāo yáng 
wave	波浪 bō làng 
way; channel	途径 tú jìng 
way of life; ecology	生态 shēng tài 
weak; frail	脆弱 cuì ruò 
weak; frail	薄弱 bó ruò 
weak point; failing	弱点 ruò diǎn 
wealth; riches	财富 cái fù 
weapon; arms; CL:种[zhong3]	武器 wǔ qì 
weight; measure	分量 fèn liàng 
what one sees and hears; knowledge; information	见闻 jiàn wén 
white; light pink; erotic; beautiful woman; powdered (with make-up)	粉色 fěn sè 
wholesale; bulk trade; distribution	批发 pī fā 
wide; open (spaces); to open up	开阔 kāi kuò 
wide open; to open up	敞开 chǎng kāi 
wide-ranging and profound; broad and deep	博大精深 bó dà jīng shēn 
wide; vast	广阔 guǎng kuò 
width; extent; range; scope	幅度 fú dù 
wife's mother, mother-in-law;	岳母 yuè mǔ 
willful; headstrong; uninhibited	任性 rèn xìng 
will; willpower; determination; CL:个	意志 yì zhì 
wing	翼 yì 
wink	眨 zhǎ 
wise; brilliant; superior	高明 gāo míng 
wise; brilliant	英明 yīng míng 
wishing one could do sth; to hate to be unable; itching to do sth; can't wait for; to wish one could do sth; to desire strongly	恨不得 hèn bu dé 
with keen interest pleasure (idiom); with gusto; to relish; eagerly; with great interest	津津有味 jīn jīn yǒu wèi 
without any sense of shame; unembarrassed; shameless	无耻 wú chǐ 
without permission; of one's own initiative	擅自 shàn zì 
with utmost care; fine; meticulous; detailed	精心 jīng xīn 
work and rest	作息 zuò xī 
worsen	恶化 è huà 
worthwhile; be a good deal; be a bargain; reckon up; calculate	合算 hé suàn 
would rather; better	宁愿 nìng yuàn 
would rather...; it would be better...; would prefer	宁肯 nìng kěn 
Wow!; sound of child's crying	哇 wa 
wrinkle; CL:道[dao4]	皱纹 zhòu wén 
write down; record; written account	记载 jì zǎi 
Xinglong county in Chengde 承德[Cheng2 de2] , Hebei	兴隆 xīng lóng 
year after year; with each passing year; over the years	逐年 zhú nián 
year (e.g. school year, fiscal year)	年度 nián dù 
years; passing of time	岁月 suì yuè 
you might as well (do it); simply; just	索性 suǒ xìng 
young; childish; naive	幼稚 yòu zhì 
