store, shop	가게
price	가격
furniture	가구
close	가깝다
sometimes	가끔
go	가다
teach	가르치다
bag	가방
light	가볍다
singer	가수
chest, breast	가슴
song	가요
middle	가운데
scissors	가위
autumn, fall	가을
most	가장
take away	가져가다
bring	가져오다
family	가족
branch	가지
have	가지다
each	각
while	간
simple, easy	간단하다
simply	간단히
snack	간식
soy sauce	간장
nurse	간호사
Galvi, spareribs	갈비
Galbitang, spareribs soup	갈비탕
brown	갈색
transfer	갈아타다
persimmon	감
cold	감기
cold medicine	감기약
close ~ (eyes)	감다
sensation	감동
be impressed	감동하다
thank	감사
thank you	감사드립니다
thank, appreciate	감사하다
thank you	감사합니다
potato	감자
Gamjatang, potato soup	감자탕
suddenly	갑자기
price	값
river	강
puppy	강아지
lecture	강좌
have	갖다
same	같다
together	같이
dog, ~ piece(s)	개
forsythia	개나리
individual	개인
there	거기
street	거리
living room	거실
mirror	거울
almost, nearly	거의
lie	거짓말
anxiety, concern	걱정
worry	걱정하다
health	건강
be healthy	건강하다
cross (a road)	건너가다
cross over	건너다
other side, opposite side	건너편
building	건물
cheers, toast	건배
walk	걷다
bet, call	걸다
get caught, take (time)	걸리다
walk (go)	걸어가다
walk (come)	걸어오다
black	검은색
that, thing, it	것
game	게임
winter	겨울
winter vacation	겨울방학
result	결과
decision	결정
decide	결정하다
marriage	결혼
wedding ceremony	결혼식
get married	결혼하다
competition, game	경기
stadium, arena	경기장
Gyeongbokgung	경복궁
Gyeongju	경주
police	경찰
police officer	경찰관
police office	경찰서
view, landscape	경치
experience	경험
stairs	계단
egg	계란
calculate	계산하다
continue	계속
be, exist (honorific form)	계시다
season	계절
plan	계획
meat	고기
high school	고등학교
high school student	고등학생
choose	고르다
Thank you (past tense)	고마웠습니다
thank	고맙다
Thank you	고맙습니다
paternal aunt	고모
paternal uncle	고모부
express bus	고속버스
cat	고양이
broken, malfunction	고장
red pepper	고추
Kochujang, red pepper paste	고추장
fix	고치다
hungry	고프다
hometown	고향
soon	곧
alley	골목
golf	골프
beautiful	곱다
place	곳
ball	공
space	공간
air	공기
public official	공무원
study	공부
study	공부하다
show, public performance	공연
park	공원
payphone, public phone	공중전화
free	공짜
notebook, note	공책
airport	공항
public holiday	공휴일
division	과
past	과거
fruit	과일
snack	과자
science	과학
relation	관계
travel, sightsee	관광하다
attention, interest	관심
advertisement	광고
be okay	괜찮다
It's fine.	괜찮습니다
textbook	교과서
professor	교수
classroom	교실
substitute, change	교체
traffic	교통
traffic accident	교통사고
church	교회
9	구
take a look	구경하다
shoes	구두
cloud	구름
90	구십
September	구월
save, seek, get	구하다
soup	국
domestic	국내
nationalestablished, state	국립
noodle	국수
Korean language	국어
nationality, country of citizenship	국적
international	국제
soldier, military personnel	군인
bake	굽다
~ book(s)	권
ear	귀
cute	귀엽다
rule	규칙
mandarin orange	귤
it	그
it	그거
it	그것
there	그곳
that day	그날
just, as it is	그냥
meantime, meanwhile, up to now	그동안
them, they	그들
then, at that time	그때
Yes, Yeah	그래
so, thus	그래서
gram	그램
but, however	그러나
so, because	그러니까
then, if so	그러면
then, such	그런
by the way, however	그런데
then	그럼
like that, so	그렇게
well, I see.	그렇구나
Yes, that's it.	그렇다
That's right.	그렇습니다
nevertheless, but	그렇지만
bowl, container, tableware	그릇
and	그리고
draw	그리다
drawing, picture	그림
stop, finish	그만
his, the person	그분
day before yesterday	그저께
among them	그중
there, the person	그쪽
stop, end, cease	그치다
theater, cinema	극장
nearby, neighborhood	근처
post, sentence, character	글
I do not know., well, I guess ~	글쎄요
soon, a little while ago	금방
no smoking	금연
Friday	금요일
abstinence, temperance	금주
class, grade	급
hurry, urgent	급하다
term, period	기간
wait	기다리다
cultivate, grow	기르다
oil, gasoline	기름
feeling	기분
glad, delight	기뻐하다
happy	기쁘다
article, driver, engineer	기사
dormitory	기숙사
remember	기억하다
temperature	기온
reporter	기자
train	기차
cough	기침
other	기타
be nervous	긴장되다
way, road	길
long	길다
seaweed	김
Kimbab	김밥
Kimchi	김치
Kimchi stew	김치찌개
Gimpo International Airport	김포공항
black color	까만색
black	까맣다
cut, shave	깎다
startled, surprised	깜짝
clean	깨끗하다
wake up, crack, break	깨다
chip, crack, break	깨지다
take out	꺼내다
chewing gum	껌
exactly, absolutely	꼭
flower	꽃
florist	꽃집
dream	꾸다
dream	꿈
turn off, extinguish, stop	끄다
boil	끓이다
end	끝
finish, end	끝나다
finish	끝내다
put on, plug, (fog) rolls in	끼다
I	나
go out, get out	나가다
share, divide	나누다
occur, come out	나다
country	나라
tree	나무
spoil, deteriorate	나빠지다
bad	나쁘다
come out, appear	나오다
age, old	나이
later, after	나중
appear	나타나다
four days	나흘
fishing	낚시
day	날
weather	날씨
date	날짜
south, man	남
leave	남기다
men and women	남녀
Namdaemun market	남대문시장
younger brother	남동생
South America	남미
north and south	남북
man	남자
south	남쪽
husband	남편
male student	남학생
day, noon, during the day	낮
low	낮다
of mine, my	내
I	내가
internal medicine	내과
next year	내년
pay, put out	내다
go down	내려가다
come down	내려오다
go down	내리다
content	내용
tomorrow	내일
pot	냄비
smell	냄새
cold noodle	냉면
refrigerator	냉장고
you	너
too, very	너무
wide	넓다
exceed, more than	넘다
fall down, fall	넘어지다
put in	넣다
yes, 4	네
necktie	넥타이
4	넷
fourth	넷째
year	년
yellow color	노란색
yellow	노랗다
song	노래
Karaoke shop	노래방
sing	노래하다
endeavor, strive	노력하다
note	노트
green	녹색
green tea	녹차
play	놀다
be surprised	놀라다
basketball	농구
high	높다
put	놓다
who	누가
who	누구
sister (as seen from the younger brother)	누나
press down, push	누르다
eye, snow	눈
tear	눈물
snowman	눈사람
staring contest, snowball fight	눈싸움
lie down, sleep	눕다
news	뉴스
New York	뉴욕
feel	느끼다
feeling	느낌
slow	느리다
always	늘
gain, increase	늘다
ability	능력
late, delay	늦다
overslept, sleeping in late	늦잠
Sir	님
all, whole	다
return, come back	다녀오다
go, commute	다니다
different	다르다
other ~, another ~, different ~	다른
bridge, leg, foot	다리
5	다섯
again	다시
next, after	다음
next month	다음달
next week	다음주
next year, following year	다음해
diet	다이어트
hurt	다치다
wipe, polish	닦다
word	단어
disadvantage, shortcoming, drawback	단점
close	닫다
shut, close	닫히다
month, moon	달
egg	달걀
sweet	달다
dollar	달러
calendar	달력
run	달리다
chicken, hen	닭
chicken	닭고기
resemble	닮다
dip, pickle	담그다
tobacco	담배
reply	답장
carrot	당근
you	당신
versus, large	대
answer	대답
answer, reply	대답하다
mostly, almost	대부분
embassy	대사관
university, college	대학
university, college	대학교
college student	대학생
graduate school	대학원
postgraduate student, graduate student	대학원생
Republic of Korea, South Korea	대한민국
conversation, dialogue	대화
competition, tournament	대회
house	댁
more	더
dirty	더럽다
hot water	더운물
thanks for, thanks to	덕분
hot	덥다
cover	덮다
bring, take along	데리다
date, dating	데이트
road	도로
library	도서관
city	도시
help	도와주다
help, assistance	도움
arrival	도착
arrive	도착하다
Tokyo	도쿄
reading	독서
reading room	독서실
read	독서하다
Germany	독일
money	돈
return, go back	돌아가다
come back, come home	돌아오다
help	돕다
town, neighborhood	동네
Dongdaemun market	동대문시장
animal	동물
brother, sister	동생
club, group	동아리
during, between	동안
eastern, orient	동양
coin	동전
east	동쪽
pig	돼지
pork	돼지고기
become	되다
fermented soybean paste	된장
soybean paste soup	된장국
soybean paste stew	된장찌개
two	두
thick	두껍다
put	두다
tofu	두부
tofu soup	두부찌개
2	둘
second, the second of~	둘째
rear, back	뒤
behind, back, towards the rear	뒤쪽
drama	드라마
give	드리다
eat (honorific form)	드시다
listening, hearing	듣기
listen	듣다
field, ~s,	들
hold, enter	들다
go in, enter	들어가다
come in, enter	들어오다
etc, back	등
hiking, mountain-climbing	등산
mountaineering clothing	등산복
hiking boots, climbing shoes	등산화
DVD	디브이디
design	디자인
warm	따뜻하다
follow	따라가다
come with, follow	따라오다
separately	따로
follow	따르다
daughter	딸
strawberry	딸기
sweat	땀
time	때
because, for ~, so~	때문
leave	떠나다
chatter, make a noise	떠들다
rice cake	떡
rice cake soup	떡국
Toppogi	떡볶이
drop	떨어지다
in addition, again	또
or	또는
same	똑같다
upright, straight	똑바로
run	뛰다
hot	뜨겁다
rise, open (the eyes)	뜨다
meaning	뜻
radio	라디오
ramen	라면
Russia	러시아
skin lotion	로션
garlic	마늘
dry	마르다
~ animal(s), ~ head(s)	마리
drink	마시다
mind, feeling	마음
last	마지막
finish, end	마치다
40	마흔
be blocked, be clogged	막히다
only, ten thousand	만
meet	만나다
dumpling	만두
make, create	만들다
if, should	만일
touch	만지다
comic book, cartoon	만화
many	많다
a lot of, many	많이
word, talk	말
words, remarks	말씀
talk	말씀하다
speaking	말하기
say, talk	말하다
clear, clean	맑다
flavor, taste	맛
not delicious	맛없다
delicious	맛있다
right, fit, correct	맞다
That's right.	맞습니다
That's right.	맞아요
across, the other side, opposite	맞은편
tie	매다
extremely, very	매우
everyday	매일
every week	매주
beer	맥주
spicy	맵다
head, hair	머리
eat	먹다
first, first of all, before	먼저
far, distant, long	멀다
cool, nice	멋있다
menu	메뉴
shoulder, carry	메다
memo	메모
message	메시지
Mexico	멕시코
a few days, what date	며칠
razor, shaving	면도
~ person(s)	명
holidays, annual events	명절
a few, a number of	몇
all, everyone	모두
the day after tomorrow	모레
I don't know.	모르겠습니다
do not know	모르다
take you, serve you (honorific form)	모시다
shape, form, style	모양
collect, gather	모으다
gather, get together	모이다
meeting, gathering	모임
hat	모자
neck, throat	목
necklace	목걸이
voice	목소리
Thursday	목요일
bath, bathing	목욕
take a bath	목욕하다
purpose	목적
body	몸
sickness, disease that comes from fatigue	몸살
~ can not do	못하다
Mongolia	몽골
radish	무
heavy	무겁다
rose of sharon	무궁화
free	무료
knee	무릎
swarm, unreasonable	무리
scary	무섭다
what	무슨
what	무엇
what	무엇이
trade	무역
dance	무용
very	무척
door, gate	문
stationery store	문구점
sentence	문장
problem	문제
culture	문화
ask	묻다
water	물
stuff, thing	물건
sure, of course	물론
ask	물어보다
what	뭐
The United States	미국
future	미래
in advance, beforehand	미리
art	미술
art gallery, art museum	미술관
sorry	미안하다
I'm sorry.	미안합니다
beauty salon	미용실
meter	미터
folk village	민속촌
flour	밀가루
be shaved, be pushed	밀리다
bottom, below	밑
change	바꾸다
be changed	바뀌다
banana	바나나
sea	바다
beach	바닷가
hope	바라다
wind	바람
immediately, soon, just	바로
right, paint, wear	바르다
busy	바쁘다
violin	바이올린
pants	바지
museum	박물관
clap, applause	박수
out, outside	밖
half, group	반
nice to meet, happy	반갑다
Nice to meet you.	반갑습니다
half a year	반년
half-moon	반달
shorts	반바지
ring	반지
side dish	반찬
receive	받다
foot, leg	발
toe(s)	발가락
pronunciation	발음
development	발전
announcement, presentation	발표
bright	밝다
night	밤
rice, meal	밥
room	방
way, method	방법
broadcast	방송
broadcast stations	방송국
vacation	방학
ship, stomach, pear	배
hungry	배고프다
volleyball	배구
delivery	배달
be full (I am full.)	배부르다
actor	배우
learn	배우다
stomachache	배탈
100	백
department store	백화점
abandon, throw away	버리다
bus	버스
~ time(s)	번
number	번호
earn, make money	벌다
already	벌써
take off (clothes, shoes)	벗다
cherry blossom	벚꽃
Beijing	베이징
Vietnam	베트남
wall	벽
lawyer	변호사
star	별
not really	별로
illness, ~ bottle(s)	병
hospital	병원
send, spend	보내다
see	보다
sidewalk, report	보도
show, look	보이다
usually, normally, in general	보통
peach	복숭아
complicated, crowded	복잡하다
fry	볶다
fried rice	볶음밥
ballpoint pen	볼펜
spring	봄
bag	봉지
envelope	봉투
meet	뵙다
real estate	부동산
soft, friendly	부드럽다
call, sing	부르다
parents	부모
couple, husband and wife, married couple	부부
Busan	부산
sideline	부업
kitchen	부엌
wife, Mrs.	부인
director	부장
diligent	부지런하다
send, fry, transmit	부치다
request, please	부탁
beg, ask	부탁하다
North	북쪽
~ person(s), ~ minute(s)	분
atmosphere	분위기
fire, electrical light	불
Bulgogi, grilled meat	불고기
blow (wind or whistle, musical instruments, etc.)	불다
uncomfortable, inconvenient	불편하다
pour	붓다
stick, pass a test	붙다
attach, stick	붙이다
Brazil	브라질
blouse	블라우스
rain	비
soap	비누
video	비디오
secret	비밀
Bibimbap, mixed rice	비빔밥
similar, like	비슷하다
expensive	비싸다
airplane	비행기
airfield, airport	비행장
building	빌딩
borrow, lend	빌리다
fast	빠르다
red color	빨간색
red	빨갛다
suck, do laundry	빨다
laundry, wash	빨래
quickly	빨리
bread	빵
bakery	빵집
remove, pull, pull out	빼다
only	뿐
4	사
intersection, four corners	사거리
four seasons	사계절
accident	사고
apple	사과
buy	사다
person, man	사람
love	사랑
love	사랑하다
case, example	사례
office	사무실
object, thing	사물
40	사십
entrepreneur, businessman	사업가
use	사용하다
temple, employee	사원
April	사월
between, while	사이
cider	사이다
size	사이즈
sign	사인하다
CEO, the president	사장
dictionary	사전
picture, photo	사진
camera	사진기
cousin	사촌
candy	사탕
3 days	사흘
mountain	산
walk	산책
flesh, ~ year(s) old	살
live	살다
3	삼
intersection, three-way intersection	삼거리
Samgyetang	삼계탕
30	삼십
March	삼월
paternal uncle	삼촌
relation	상관
box	상자
wound, scratch	상처
product	상품
bird, new	새
newly	새로
dawn, late at night, early morning	새벽
shrimp	새우
color	색
color	색깔
sandwich	샌드위치
thinking, thought	생각
be considered, it seems~	생각되다
think	생각하다
form, arise	생기다
fish	생선
birthday (honorific form)	생신
birthday	생일
life	생활
take a shower	샤워하다
shampoo	샴푸
stand	서다
each other, both	서로
document	서류
30	서른
service	서비스
western, west	서양
Seoul	서울
Seoul station	서울역
bookstore	서점
west, western	서쪽
gift, present	선물
elder, senior	선배
teacher	선생님
player	선수
choose, select	선택하다
fan	선풍기
washing dishes, dish-washing	설거지
Lunar New Year	설날
Seolleongtang	설렁탕
explanation, description	설명
explain	설명하다
Mt. Seorak	설악산
sugar	설탕
island	섬
castle, last name	성
personality	성격
name	성함
world	세계
wash	세수하다
set up, formulate	세우다
have a sale	세일하다
washing machine	세탁기
dry cleaners, laundromat	세탁소
center	센터
centimeter	센티미터
3	셋
third	셋째
small, cow	소
introduction	소개
introduce	소개하다
beef	소고기
salt	소금
sound, voice	소리
novel	소설
novelist	소설가
news	소식
sofa	소파
parcel	소포
picnic, trip	소풍
peptic, digestive	소화제
inside	속
hand	손
finger	손가락
customer	손님
handkerchief	손수건
bunch, flower, cluster	송이
shopping	쇼핑
towel, washcloth	수건
capital, water supply	수도
tap water	수돗물
watermelon	수박
operate on for	수술하다
class, lesson	수업
swimming	수영
swimsuit	수영복
swimming pool	수영장
Wednesday	수요일
chopsticks and a spoon	수저
note, notebook	수첩
mathematics	수학
homework	숙제
order, turn	순서
spoon	숟가락
alcohol, liquor	술
rest	쉬다
50	쉰
easy	쉽다
supermarket	슈퍼마켓
20	스물
sweater	스웨터
skate	스케이트
ski, skiing	스키
ski resort	스키장
star	스타
stockings	스타킹
stress	스트레스
Spanish	스페인어
sport	스포츠
sorrow, mourn	슬퍼하다
sad	슬프다
habit	습관
city, time	시
time	시간
schedule, timetable	시간표
clock	시계
countryside	시골
noisy	시끄럽다
downtown, city, stream	시내
sour	시다
CD	시디
citizen	시민
facility	시설
suburbs	시외
cool, refresh	시원하다
October	시월
start	시작
begin	시작되다
start, begin	시작하다
market	시장
city hall	시청
make someone do, order	시키다
exam, test	시험
restaurant, cafeteria	식당
meal	식사
table	식탁
god, new	신
put on, wear	신다
newspaper	신문
shoes, footwear	신발
application forms	신청서
put in for, apply for	신청하다
excuse	실례
be excused	실례하다
mistake, failure	실수
hate	싫다
dislike, hate	싫어하다
severe, terrible	심하다
10	십
December	십이월
November	십일월
not salty	싱겁다
want	싶다
cheap, wrap	싸다
fight	싸우다
rice	쌀
cooked rice	쌀밥
stack up, pile up	쌓이다
chop, cut	썰다
writing, dictation	쓰기
write, use, wear (glasses)	쓰다
garbage	쓰레기
be written, be used	쓰이다
seed, Mr. ~	씨
each, every, per	씩
chew, bite	씹다
wash	씻다
Miss, daughter	아가씨
baby, toddler	아기
earlier, while ago	아까
wife	아내
no	아뇨
no	아니다
no	아니오
no	아니요
son	아들
Arabic	아랍어
bottom, under	아래
beautiful	아름답다
maybe, perhaps	아마
any	아무
father	아버님
father	아버지
dad	아빠
Asia	아시아
child	아이
ice cream	아이스크림
uncle, mister	아저씨
very, completely	아주
old lady, madame, aunt	아주머니
old lady, madame, aunt	아줌마
yet, still	아직
morning, breakfast	아침
breakfast	아침밥
breakfast	아침식사
apartment, mansion	아파트
painful, sick	아프다
Africa	아프리카
9	아홉
90	아흔
musical instrument	악기
within, not ~	안
glasses	안경
guide, invite	안내하다
hi, hello	안녕하세요
hello	안녕하십니까
embrace, cradle	안다
safe	안전하다
sit	앉다
know	알다
inform	알리다
fit, appropriate	알맞다
I understood.	알았습니다
front, previous	앞
child	애
accessory	액세서리
baseball	야구
vegetable	야채
about, medicine	약
slightly, a little	약간
pharmacy	약국
pharmacist	약사
appointment, promise	약속
thin	얇다
amount, sheep	양
socks	양말
suit	양복
form, western style	양식
onion	양파
talk	얘기하다
shoulder	어깨
which, how	어느
dark	어둡다
where	어디
which, what	어떤
how	어떻게
how	어떻다
How is it?	어떻습니까?
difficult	어렵다
adult	어른
young	어리다
child	어린이
oh, well	어머
mother	어머니
mother	어머님
hurry, quickly	어서
look good on, befit	어울리다
yesterday	어저께
yesterday	어제
last night	어젯밤
sister (as seen from the younger sister)	언니
when	언제
always, anytime	언제나
face	얼굴
how much	얼마나
ice	얼음
mom	엄마
none, no, not	없다
without	없이
air conditioner	에어컨
yen	엔
elevator	엘리베이터
passport	여권
here	여기
here and there	여기저기
8	여덟
younger sister	여동생
80	여든
various, many	여러
several, various	여러가지
everyone, ladies and gentlemen	여러분
summer	여름
hello	여보세요
6	여섯
woman	여자
female student	여학생
travel	여행
travel agency, travel firm	여행사
station	역
history	역사
contact information	연락처
age (honorific form)	연세
practice	연습
practice	연습하다
celebrity	연예인
pencil	연필
consecutive holidays	연휴
10	열
open	열다
be opened	열리다
key	열쇠
hard, enthusiastic	열심히
train	열차
postcard	엽서
spirit, zero	영
The United Kingdom	영국
video	영상
English	영어
English conversation	영어회화
minus, below zero	영하
movie	영화
movie theater	영화관
movie star	영화배우
movie ticket	영화표
side	옆
yes	예
example, model sentence	예문
pretty, beautiful	예쁘다
60	예순
reservation	예약
a long ago, olden days	옛날
5	오
today	오늘
come	오다
long, much	오래
after a long time	오래간만
Long time no see.	오래간만입니다
after a long time	오랜만
after a long time	오랜만에
for a long time	오랫동안
orange	오렌지
climb	오르다
right side, right	오른쪽
duck	오리
brother (as seen from the younger sister)	오빠
50	오십
May	오월
cucumber	오이
morning, a.m.	오전
squid	오징어
afternoon	오후
go up	올라가다
come up	올라오다
put on, place	올려놓다
olympic	올림픽
this year	올해
move, transfer, translate	옮기다
dress, clothes	옷
clothing store	옷가게
closet	옷장
shirt	와이셔츠
why	왜
because	왜냐하면
foreign country	외국
foreign language	외국어
foreigner	외국인
lonely	외롭다
maternal uncle	외삼촌
maternal aunt	외숙모
go out	외출하다
maternal grandmother	외할머니
maternal grandfather	외할아버지
left	왼쪽
fee	요금
Jordan	요르단
cooking, cuisine	요리
day of the week	요일
nowadays, around this time, lately	요즘
we, us	우리
our country, South Korea	우리나라
umbrella	우산
first	우선
milk	우유
post office	우체국
stamp	우표
exercise	운동
sportswear, gym clothes	운동복
athlete	운동선수
playground, athletic field	운동장
exercise	운동하다
sports shoes	운동화
drive	운전하다
cry	울다
make cry, chime	울리다
move	움직이다
funny, make someone laugh	웃기다
laugh	웃다
won (currency units of Korea)	원
one-piece dress	원피스
want, wish, desire	원하다
month	월
monthly salary	월급
world cup	월드컵
monthly rent	월세
Monday	월요일
for some reason, What was it?	웬일
top, up	위
location, position	위치
for, in favor of, for the sake of	위하다
dangerous	위험하다
Europe	유럽
glass	유리
famous	유명하다
June	유월
study abroad	유학
foreign student, international student	유학생
trend	유행
6	육
60	육십
bank	은행
bank clerk	은행원
drink, soft drink	음료수
record	음반
food, cooking	음식
music	음악
musician	음악가
Yeah (answer)	응
meaning	의미
doctor	의사
chair	의자
this, tooth, 2	이
this	이거
this	이것
this place, here	이곳
later	이따가
this, such ~	이런
like this, so, in this way	이렇게
like this	이렇다
name	이름
e-mail	이메일
maternal aunt	이모
maternal uncle	이모부
this time	이번
this person	이분
move, moving	이사
more than, strange	이상
strange, funny, weird	이상하다
20	이십
story	이야기
talk	이야기하다
usage	이용
use	이용하다
February	이월
reason	이유
now	이제
Egypt	이집트
this way, here, this person	이쪽
two days	이틀
understanding	이해
understand	이해하다
sign, ~ person(s)	인
population	인구
popularity	인기
popular star	인기스타
India	인도
greetings	인사
greet	인사하다
ginseng	인삼
impression	인상
Incheon	인천
internet	인터넷
interview	인터뷰하다
doll	인형
work, 1, day	일
7	일곱
diary	일기
weather forecast	일기예보
Japan	일본
Japanese drama	일본드라마
Japanese language	일본말
Japanese people	일본사람
Japanese language	일본어
Japanese food	일본요리
everyday life	일상생활
Japanese style, Japanese food	일식
rise, stand, occur	일어나다
get up, stand up	일어서다
Sunday	일요일
January	일월
one week	일주일
early	일찍
work	일하다
70	일흔
reading	읽기
read	읽다
lose	잃다
lose	잃어버리다
mouth	입
entrance	입구
put on, wear	입다
hospitalize	입원하다
admission	입학
have, there	있다
forget	잊다
forget	잊어버리다
character, Here we go.	자
myself, own	자기
sleep	자다
car, automobile	자동차
car company	자동차회사
material, document	자료
cut	자르다
seat, location	자리
myself, own	자신
nature	자연
freedom	자유
Jajangmyeon	자장면
bicycle	자전거
often	자주
last year	작년
small	작다
uncle	작은아버지
aunt	작은어머니
glass, ~ cup(s)	잔
party, feast	잔치
well	잘
mistake	잘못
handsome	잘생기다
do well, good at	잘하다
slumbers, sleep	잠
for a while, a little	잠깐
for a bit, for a while, a little	잠시
sleep, go to bed	잠자다
catch, grab, hold	잡다
eat (honorific form)	잡수시다
magazine	잡지
~ chapter(s), ~ sheet(s)	장
gloves	장갑
rainy season	장마
rainy season	장마철
rose	장미
place	장소
advantage	장점
material	재료
not funny, uninteresting	재미없다
interesting	재미있다
jacket	재킷
that	저
that	저거
that	저것
over there	저곳
there, over there	저기
dinner, evening, night	저녁
dinner	저녁식사
like that, in that way	저렇게
that person	저분
there, over there	저쪽
we	저희
enemy	적
be few, write down	적다
all, before	전
major	전공
electric car	전기자동차
electronic dictionary	전자사전
tell	전하다
not at all	전혀
telephone	전화
telephone	전화기
phone number	전화번호
~ section(s), temple	절
never, absolutely	절대
young	젊다
point	점
score, point	점수
lunch	점심
lunchtime	점심시간
lunch	점심식사
clerk	점원
jacket	점퍼
chopsticks	젓가락
station, depot	정거장
degree	정도
station, bus stop	정류장
straighten out, organize	정리하다
really, truly	정말
front door, main gate	정문
information	정보
choose, establish	정하다
I	제가
title	제목
most	제일
Jeju Island	제주도
a little	조금
investigate	조사하다
shipbuilding, Korea	조선
Korean language	조선말
Korean language	조선어
be careful, warn	조심하다
silent, quiet	조용하다
quietly	조용히
nephew	조카
graduation	졸업
graduate	졸업하다
a little	좀
a little more	좀더
narrow	좁다
Jong-ro	종로
kind, type	종류
employee	종업원
paper	종이
all day	종일
good	좋다
like	좋아하다
sorry	죄송하다
week	주
give	주다
mainly	주로
weekend	주말
pocket, pouch	주머니
sleep, rest	주무시다
order	주문하다
around	주변
housewife	주부
injection	주사
address	주소
juice	주스
around	주위
owner	주인
parking lot	주차장
park	주차하다
orange color	주황색
bamboo, porridge	죽
die	죽다
preparation	준비
prepare	준비하다
line, column, string	줄
shrink, decrease	줄다
medium, during	중
China	중국
Chinese	중국어
Chinese restaurant	중국집
Chinese cuisine	중식
center	중심
importance	중요
important	중요하다
middle school, Junior high school	중학교
middle school student	중학생
have fun	즐거워하다
fun, be pleasant	즐겁다
enjoy, have fun	즐기다
symptom, medical condition	증세
tardy, being late	지각
wallet	지갑
now	지금
pass by	지나다
last month	지난달
last time	지난번
last week	지난주
stay, spend, live	지내다
lose	지다
map	지도
fat, region	지방
eraser	지우개
protect	지키다
underground	지하
underpass	지하도
subway	지하철
subway station	지하철역
job, profession	직업
employee, staff	직원
workplace	직장
directly, direct	직접
azalea	진달래
quality	질
question	질문
ask a question	질문하다
load, baggage	짐
house, shop	집
build, create	짓다
salty, make (the plan)	짜다
a value (won coin)	짜리
short	짧다
side, page	쪽
about, around ~	쯤
stew, soup	찌개
pierce, take (a photo), press	찍다
car, tea	차
cold	차갑다
kick	차다
prepare, arrange	차리다
be good, friendly	착하다
really, very	참
window	창문
find, visit	찾다
go to visit	찾아가다
come to visit	찾아오다
vegetable	채소
book	책
bookstore	책방
desk	책상
responsibility	책임
bookshelf	책장
first, for the first time	처음
Nice to meet you.	처음 뵙겠습니다
1000	천
slowly	천천히
iron, season	철
first	첫
first	첫째
blue jeans	청바지
vacuum cleaner	청소기
sweep, clean	청소하다
~second(s)	초
invite	초대하다
elementary school	초등학교
elementary student	초등학생
green color	초록색
chocolate	초콜릿
take a picture	촬영하다
best, the highest	최고
dance	추다
Chusoku (Korean Thanksgiving Day)	추석
memory	추억
football, soccer	축구
festival	축제
celebration	축하
celebrate	축하하다
congratulations	축하합니다
exit	출구
go to work	출근하다
start, departure	출발
depart	출발하다
business trip	출장
dance	춤
dance	춤추다
cold	춥다
hobby	취미
cancel	취소하다
get a job	취직하다
layer, ~ floor	층
dentist, dentistry	치과
treat	치료하다
skirt	치마
toothpaste	치약
friend	친구
be kind	친절하다
relative	친척
close, familiar	친하다
7	칠
70	칠십
July	칠월
blackboard	칠판
bed	침대
toothbrush	칫솔
card	카드
curry	카레
camera	카메라
cafe, coffee shops	카페
knife, cutlery, swords	칼
Canada	캐나다
coffee	커피
coffee shop	커피숍
computer, PC	컴퓨터
cup	컵
cake	케이크
turn on (the light, the power, etc.)	켜다
nose	코
coat	코트
nosebleed	코피
Coke	콜라
humming	콧노래
snot, nasal discharge	콧물
bean, soy	콩
size	크기
big, large	크다
Christmas	크리스마스
uncle	큰아버지
aunt	큰어머니
key, height	키
kilogram	킬로그램
kilometer	킬로미터
ride, get on	타다
towel	타월
table tennis	탁구
Thailand	태국
Taekwondo	태권도
be born	태어나다
typhoon	태풍
taxi	택시
entertainers	탤런트
terminal	터미널
tennis	테니스
table	테이블
TV	텔레비전
tomato	토마토
Saturday	토요일
barrel, ~ package(s)	통
bank book, (deposit) passbook	통장
pass, lead	통하다
leave the office	퇴근하다
especially	특별히
characteristic, feature	특징
especially, in particular	특히
turn on (the switch)	틀다
wrong	틀리다
t-shirt	티셔츠
team	팀
wave, green onion	파
blue color	파란색
blue	파랗다
party	파티
8	팔
sell	팔다
sell, be sold	팔리다
80	팔십
August	팔월
fashion	패션
percent	퍼센트
page	페이지
pen	펜
spread, stretch	펴다
side, episode	편
letter	편지
comfortable, easy, convenient	편하다
Pyongyang	평양
weekday	평일
grape	포도
packing	포장
table, ticket	표
expression	표현
deeply	푹
pool, grass	풀
solve	풀다
France	프랑스
program	프로그램
print	프린트
blood	피
tired	피곤하다
bloom	피다
piano	피아노
smoke, bloom	피우다
pizza	피자
film	필름
necessity	필요
need	필요하다
pencil case	필통
1	하나
sky	하늘
sky blue, light blue	하늘색
do, say	하다
one day	하루
boarding house, lodging house	하숙
boarding house, lodging house	하숙집
white color	하얀색
white	하얗다
but, however	하지만
crane	학
school	학교
semester	학기
grade, school year	학년
student	학생
student ID card	학생증
academy, school	학원
one, one of the ~	한
Han River, Hangang	한강
Korea	한국
Korean drama	한국드라마
Korean language	한국말
Korean people	한국사람
Korean language	한국어
Korean cuisine	한국요리
Hangul	한글
once	한번
Hanbok, Korean traditional clothes	한복
Korean cuisine	한식
Chinese character	한자
grandmother	할머니
grandfather	할아버지
sale, discount	할인
together	함께
pass	합격
always	항상
year, sun	해
overseas	해외
overseas trip	해외여행
cell phone, mobile phone	핸드폰
hamburger	햄버거
sunshine, sunlight	햇빛
happiness	행복
happy	행복하다
event	행사
waist, hip	허리
cash	현금
now, current	현재
brother (as seen from the younger brother)	형
big brother (honorific form)	형님
sibling	형제
No. ~	호
tiger	호랑이
Australia	호주
hotel	호텔
alone	혼자
home page	홈페이지
black tea	홍차
anger	화
artist, painter	화가
angry	화나다
get angry	화내다
Tuesday	화요일
restroom, toilet, lavatory	화장실
cosmetics	화장품
makeup	화장하다
confirm, check	확인하다
welcome	환영하다
patient	환자
company	회사
employee	회사원
grey	회색
conference	회의
crosswalk	횡단보도
after	후
Junior	후배
vacation, holiday	휴가
cell phone, mobile phone	휴대전화
holiday	휴일
toilet paper	휴지
trash can	휴지통
cloudy	흐리다
white color	흰색
power	힘
household account book	가계부
furniture store	가구점
near	가까이
to cultivate	가꾸다
poverty	가난
to be thin	가늘다
possibility, potentiality	가능
possibility	가능성
to be possible	가능하다
full	가득
to sink	가라앉다
to be itchy	가렵다
powder soap	가루비누
to distinguish	가리다
to indicate	가리키다
motionlessly	가만히
drought	가뭄
housework	가사
virtual	가상
gas	가스
humidifier	가습기
entry	가입
home appliances	가전제품
family	가정
being family-oriented	가족적
livestock	가축
value	가치
separately, each	각각
each one	각자
various	각종
interval	간격
eagerly	간절히
being indirect	간접적
signboard	간판
nursing	간호
to change	갈다
conflict	갈등
more and more	갈수록
to change clothes	갈아입다
sense	감각
to be twined	감기다
director	감독
moving (emotionally)	감동적
appreciation	감상
reduction	감소
emotion	감정
admiration	감탄
river water	강물
riverside	강변
teacher	강사
rain precipitation	강수량
lecture	강연
(the amount of) rainfall	강우량
lecture	강의
lecture hall	강의실
emphasis	강조
to be strong	강하다
to prepare	갖추다
to return, to reward	갚다
start of course (lecture)	개강
frog	개구리
naughty child	개구쟁이
to clear up	개다
opening ceremony	개막식
development	개발
opening, opening to the public	개방
being open	개방적
improvement	개선
individuality	개성
being characteristic	개성적
being personal	개인적
hosting (an event)	개최
being objective	객관적
guest room	객실
to be slim and long	갸름하다
that person	걔
transaction	거래
spider	거미
turtle	거북이
change	거스름돈
rejection	거절
lies	거짓
to go through	거치다
bubble	거품
worries	걱정거리
healthy diet	건강식
healthy food	건강식품
across	건너
to hand over, to start (a conversation)	건네다
solid ingredients of a soup	건더기
forgetfulness	건망증
construction	건설
batteries	건전지
dry	건조
architecture	건축
architect	건축가
rag	걸레
mopping	걸레질
steps	걸음
black	검다
inspection	검사
search	검색
search word	검색어
fear	겁
side, outside	겉
appearance	겉모습
besides, in addition	게다가
bulletin board	게시판
to be lazy	게으르다
game machine	게임기
barely, finally	겨우
encouragement	격려
to experience, to go through	겪다
to endure	견디다
being as a result	결과적
after all	결국
conclusion	결론
end (of a story)	결말
absence	결석
final game/round	결승전
decision	결심
never	결코
wedding anniversary	결혼기념일
wedding hall	결혼식장
humility	겸손
overlap	겹치다
warning	경고
career	경력
security	경비
security guard	경비원
management	경영
executive, CEO	경영자
business administration	경영학
case, circumstance	경우
competition	경쟁
competitiveness	경쟁력
economy	경제
economic power	경제력
being economic	경제적
economics	경제학
calculation, accounting	계산
cashier	계산대
check, bill	계산서
contract	계약
down payment	계약금
(written) contract	계약서
bank account	계좌
hierarchy	계층
planning	계획성
being planned, as planned	계획적
head, hill	고개
client, customer	고객
sweet potato	고구마
traditional Korean palace	고궁
high grade	고급
whale	고래
thankfulness	고마움
rubber shoes	고무신
rubber band	고무줄
worry, trouble	고민
confession	고백
hardship	고생
to be nutty	고소하다
high speed	고속
highway	고속도로
orphanage	고아원
unique	고유하다
notice	고지서
persistence	고집
pepper powder	고춧가루
upper floors	고층
pain	고통
difficulty	곤란
evenly	골고루
alley	골목길
to be annoying	골치가 아프다
bear	곰
natural curly hair	곱슬머리
here and there, everywhere	곳곳
utility charges	공공요금
public place	공공장소
joint	공동
community life	공동생활
construction	공사
to be polite	공손하다
performance hall	공연장
factory	공장
princess	공주
common	공통
common point	공통점
fear	공포
pollution	공해
overwork	과로
(class) subject	과목
waste (of use)	과소비
speed violation	과속
overeating	과식
as expected	과연
tutor lesson	과외
excessive drinking	과음
manager	과장
to exaggerate	과장하다
process	과정
task	과제
scientists	과학자
being scientific	과학적
audience	관객
to be unrelated	관계없다
the person concerned	관계자
tourism	관광
tourist	관광객
tourist attraction	관광지
viewing	관람
audience	관람객
relation	관련
relevance	관련성
management	관리
management room	관리실
idiom	관용어
observation	관찰
square, plaza	광장
for no reason	괜히
agony, distress	괴로움
to be distressed	괴로워하다
to be painful	괴롭다
to harass, to bully	괴롭히다
to be great, to be wonderful	굉장하다
extremely, to a great extent	굉장히
teacher	교사
suburbs	교외
education	교육
educator	교육자
pedagogy	교육학
teaching materials	교재
transportation	교통수단
transportation	교통편
overseas resident	교포
exchange	교환
a stingy person	구두쇠
to roll	구르다
purchase	구매
hole	구멍
distinction	구별
classification	구분
composition	구성
grill	구이
a job offer	구인
purchase	구입
structure	구조
rescue team	구조대
being specific	구체적
nation	국가
soup bowl	국그릇
domestic flights	국내선
(the country's) literature	국문학
soup bowl	국물
citizens	국민
traditional Korean music	국악
overseas resident	국외
international marriage	국제결혼
international flights	국제선
chrysanthemum	국화
army	군대
place	군데
to be thick	굵다
curiosity	궁금증
to be curious	궁금하다
to recommend, to offer	권하다
earrings	귀걸이
return (to home country)	귀국
ghost	귀신
to be valuable	귀중하다
to be bothersome, to be tedious	귀찮다
to be noble, to be rare, to be fine	귀하다
being regular	규칙적
swing	그네
girlfriend	그녀
shade	그늘
as it is	그대로
(but) still	그래도
so that	그래야
graph	그래프
therefore	그러니
and then	그러다가
hence	그러므로
and then	그러자
so, as such, like that	그러하다
(how to count trees), stump	그루
group	그룹
so, very, that	그리
to miss, to be nostalgic	그리워하다
then	그리하여
picture book	그림책
to be nostalgic, to be missed	그립다
to quit	그만두다
that much	그만큼
just	그저
by the way	근데
worker, laborer	근로자
work	근무
muscle	근육
oh well	글쎄
author	글쓴이
letter	글씨
letter	글자
to scratch	긁다
gold	금
gold medal	금메달
amount of money	금액
ban	금지
suddenly	급히
being positive, being affirmative	긍정적
machine	기계
commemoration	기념
memorial hall	기념관
anniversary	기념일
souvenir	기념품
function	기능
to crawl	기다
expectation	기대
prayer	기도
pillar	기둥
record	기록
basic	기본
being fundamental, being basic	기본적
donation	기부
joy, happiness	기쁨
skill, technique	기술
technician	기술자
memory	기억
to remember, to recall	기억나다
memory	기억력
company, corporation	기업
entrepreneur	기업인
energy, qi	기운
to tilt	기울이다
standard, criteria	기준
train station	기차역
train ticket	기차표
basic, fundamental	기초
travelogue, travel essay	기행문
symbol	기호
married	기혼
opportunity, change	기회
climate	기후
nervousness	긴장감
roadside	길가
street	길거리
lenth	길이
a custom/event to make Kimchi in winter	김장
to be deep	깊다
depth	깊이
to peel	까다
to have a high standard	까다롭다
to lay	깔다
forgetfully, with a blink	깜빡
clearly	깨끗이
to realize	깨닫다
to break	깨뜨리다
sesame salt	깨소금
to wake someone up	깨우다
sesame leaf	깻잎
to go out, to be extinguished	꺼지다
peel, skin	껍질
tail	꼬리
properly (without failure), faithfully	꼬박꼬박
summit, top	꼭대기
the last place	꼴찌
to be meticulous	꼼꼼하다
thoroughly, meticulously	꼼꼼히
flower vase	꽃병
quite	꽤
to decorate	꾸미다
steadily	꾸준히
to scold	꾸짖다
honey	꿀
honey bee	꿀벌
to dream	꿈꾸다
string	끈
to cut	끊다
to be cut	끊어지다
to be incessant, to be unceasing	끊임없다
to pull	끌다
finally, eventually	끝내
to interrupt	끼어들다
day by day	나날이
picnic	나들이
depends on	나름
remainder, surplus	나머지
(Korean style) seasoned vegetables	나물
leaf	나뭇잎
to go forward, to get involved	나서다
to move on	나아가다
to improve	나아지다
to display, to reveal	나타내다
doodle	낙서
fallen leaves	낙엽
stove, fireplace	난로
heater	난방
wings	날개
to fly	날다
day by day	날로
to blow away	날리다
skinny	날씬하다
to fly away	날아가다
to fly around	날아다니다
to fly in	날아오다
to fly up, to soar	날아오르다
to be old	낡다
men and women of all ages	남녀노소
gender equality	남녀평등
to remain, to be left	남다
southern	남부
male	남성
men's clothing	남성복
to heal	낫다
waste (of use)	낭비
to be unfamiliar	낯설다
to give birth	낳다
always	내내
to look down	내려다보다
underwear	내복
inside, internal	내부
being shy	내성적
content (of a container)	내용물
to kick out	내쫓다
stream, lake	냇가
excessive air conditioning syndrome	냉방병
to be generous	너그럽다
too~, very	너무나
to be enough, to be rich	넉넉하다
to dry, to expose to the air	널다
to widen	넓히다
to hand over	넘기다
to move on to	넘어가다
to overflow	넘치다
to be squared	네모나다
network	네트워크
age	년대
labor	노동
laborer	노동자
effort	노력
route, line	노선
elderly and physically handicapped	노약자
elderly	노인
an unmarried and old woman	노처녀
unmarried and old man	노총각
laptop	노트북
to be melt	녹다
voice recording	녹음
voice recorder	녹음기
(academic) paper	논문
to be amazing, to be remarkable	놀랍다
to make fun of	놀리다
play, game	놀이
playground	놀이터
guy	놈
joke	농담
farmer	농민
farmer	농부
agriculture	농사
pesticides	농약
crops	농작물
rural	농촌
height	높이
to increase	높이다
honorifics	높임말
to be placed	놓이다
to miss, to lose	놓치다
glance, attention	눈길
eye-level	눈높이
eye disease	눈병
snowstorm	눈보라
avalanche	눈사태
eyebrow	눈썹
wits, sense	눈치
to wear deeply	눌러쓰다
to be lazy, to be laid back	느긋하다
to be greasy	느끼하다
to increase (the number or volume)	늘리다
to stretch, to increase	늘어나다
to line up	늘어서다
to get old	늙다
to delay	늦추다
to approach, to come closer	다가오다
to visit	다녀가다
squirrel	다람쥐
to deal with	다루다
ironing	다림질
many	다수
to be varied	다양하다
next day	다음날
to be compassionate, to be kind	다정하다
to argue, to fight	다투다
fortune, luck	다행
fortunately	다행히
stage, step	단계
regular (customer)	단골
short term	단기간
to be solid, to be hard, to be strong	단단하다
(women's) short hairstyle	단발머리
protein	단백질
control, regulate (illegal action)	단속
to be simple	단순하다
simply	단순히
unit	단위
to be neat, to be organized	단정하다
group	단체
autumn leaves, maple	단풍
to change	달라지다
to run (to go)	달려가다
to run (to come)	달려오다
besides, differently	달리
running	달리기
moonlit night	달밤
to escape	달아나다
to be sweet	달콤하다
Korean style chicken dish	닭갈비
wall, fence, hedge	담
to be put in (a container)	담기다
to put in (a container)	담다
being in charge	담당
person in charge	담당자
to be pure, to be innocent	담백하다
tobacco fire	담뱃불
homeroom teacher	담임
answer	답
reply	답글
to be stuffy, to be suffocating	답답하다
answer	답변
to pull	당기다
for a while (from now on)	당분간
to be natural,to be justifiable,to be fair	당연하다
of course	당연히
immediately, for now	당장
to be done	당하다
to be embarrassed, to be bewildered	당황하다
mostly, usually	대개
large company	대기업
to touch	대다
to be great	대단하다
greatly	대단히
big city	대도시
mass, a large amount	대량
substitute	대리
door, gate	대문
in substitute	대신
rental	대여
rental charge	대여료
hospitality	대접
public	대중
public transportation	대중교통
public bath	대중목욕탕
countermeasures	대책
housecleaning	대청소
usually, in general	대체로
loan, lend	대출
president (of a country)	대통령
representative	대표
being representative, being typical	대표적
large size	대형
dance	댄스
furthermore, moreover	더구나
to get dirty	더러워지다
even more	더욱
heat, hotness	더위
to add on, to get worse	더하다
thanks (to someone)	덕
to throw	던지다
less, not yet	덜
to cut back	덜다
to get burned	데다
to bring	데려오다
to boil quickly	데치다
tool	도구
theft	도난
how on earth	도대체
thief	도둑
to escape, to run away	도망가다
books	도서
lunchbox	도시락
seal, stamp	도장
challenge	도전
on the way	도중
poison	독
influenza, flu	독감
independence	독립
room to oneself, solitary confinement	독방
an unmarried, single person	독신자
to be unique	독특하다
stone, rock	돌
to spin, to get around	돌다
to get returned	돌려받다
to return	돌려보내다
to return	돌려주다
to turn	돌리다
to take care	돌보다
stone pot	돌솥
to walk around	돌아다니다
to look back	돌아보다
to turn back	돌아서다
1st birthday	돌잔치
cave	동굴
colleague	동료
zoo	동물원
eastern part	동부
eastern and western	동서양
simultaneous	동시
oriental painting	동양화
video	동영상
being the same	동일하다
motion, action	동작
alumni	동창
alumni association	동창회
east coast	동해안
club	동호회
fairy tale	동화
children's book	동화책
as much as possible	되도록
to regain	되돌리다
to look back, to think back	되돌아보다
to revive	되살아나다
fear	두려움
to fear	두려워하다
two, three	두세
headache	두통
headache pill/medicine	두통약
to be dull	둔하다
to look around	둘러보다
to be round	둥글다
to be inferior, to be behind	뒤떨어지다
to flip	뒤집다
after-party	뒤풀이
the back view	뒷모습
back gate	뒷문
behind story	뒷이야기
back seat	뒷자리
finally	드디어
dry	드라이
dream	드림
to be rare	드물다
to be reassuring, to be reliable	든든하다
to tell (someone)	들려주다
to stop by	들르다
to be heard	들리다
to try hearing	들어보다
to listen (to someone)	들어주다
to spend (time, money)	들이다
register	등록
registration fee, tuition fee	등록금
registration card	등록증
lights, lamp	등불
disc, hernia	디스크
designer	디자이너
digital	디지털
to pluck, to pick, to get	따다
to follow (after someone)	따라다니다
therefore, hence	따라서
separately	따로따로
to question closely	따지다
perfectly, just	딱
to be hard, to be stiff	딱딱하다
another, other	딴
land, ground	땅
peanuts	땅콩
sometimes	때때로
now and then	때로
to float	떠오르다
to shiver, to shake	떨다
to tremble, to be shaken	떨리다
to drop	떨어뜨리다
to detach, to take away	떼다
word by word, letter by letter	또박또박
also	또한
similarly, in the same manner	똑같이
to be clever, to be smart	똑똑하다
to be clear	뚜렷하다
to make a hole	뚫다
to be fat	뚱뚱하다
to run	뛰어가다
to be superior	뛰어나다
to jump off	뛰어내리다
to jump over	뛰어넘다
to jump around, to run around	뛰어다니다
to run (to come)	뛰어오다
to rush out, to leap out	뛰쳐나가다
to become hot	뜨거워지다
unexpectedly	뜻밖에
zodiac	띠
lamp	램프
lemon	레몬
leisure sports	레포츠
lens	렌즈
car rental	렌터카
lottery	로또
robot	로봇
lobby	로비
roommate	룸메이트
rhythm	리듬
remote controller	리모컨
deadline, due date	마감일
mannequin	마네킹
garden	마당
section	마디
marathon	마라톤
to provide, to prepare	마련하다
indoor floor	마루
conclusion	마무리
magic	마술
mask	마스크
drug	마약
village	마을
as much as one wants	마음껏
as one wishes	마음대로
to make up one's mind	마음먹다
mindfulness	마음씨
to come face to face	마주보다
to meet (coincidentally)	마주치다
pick up	마중
being the same, in the same manner	마찬가지
as if, just like	마치
just happened to be	마침
finally	마침내
marketing	마케팅
supermarket	마트
insanely, do something without any order	막
the youngest	막내
to block	막다
rod, stick	막대기
last train	막차
encounter, meeting	만남
fountain pen	만년필
by any chance	만약
satisfaction	만족
satisfaction (feeling)	만족감
cartoon book	만화책
eldest daughter	맏딸
eldest son	맏아들
quarrel	말다툼
to stop (conflict)	말리다
the way one speaks	말투
to taste	맛보다
to break, to ruin	망가뜨리다
to be broken, to be ruined	망가지다
to hesitate	망설이다
to perish, to breakdown	망하다
dual-income family	맞벌이
greeting	맞이
to assemble	맞추다
to entrust	맡기다
to take over, to undertake	맡다
annually, every year	매년
monthly, every month	매달
attraction	매력
being attractive	매력적
soot	매연
spicy fish soup	매운탕
shop	매점
sold out	매진
medium	매체
to be sweet and spicy	매콤하다
ticket office	매표소
barefoot	맨발
bare hands	맨손
blind person	맹인
to tie	맺다
hair	머리카락
to stay	머무르다
to be not distant	머지않다
food	먹을거리
(animal) feed	먹이
to feed	먹이다
dust	먼지
far away	멀리
multimedia room	멀티미디어실
to stop	멈추다
to be fantastic, to be amazing	멋지다
bruise	멍
e-mail	메일
melody	멜로디
melon	멜론
daughter-in-law	며느리
side, noodles	면
duty-free shop	면세점
interview	면접
interviewer	면접관
interview test	면접시험
license	면허증
cheerfulness, brightness	명랑
to be cheerful, to be bright	명랑하다
noun	명사
famous place	명소
masterpiece, designer goods	명품
some, few	몇몇
native language	모국어
mosquito	모기
model	모델
sand	모래
model student	모범생
appearance	모습
vowel	모음
to be insufficient	모자라다
recruitment	모집
adventurous mind	모험심
model, figure	모형
to be thirsty	목마르다
pastor	목사
life	목숨
public bath	목욕탕
destination	목적지
target, goal	목표
to be unaware of, to not realize	몰라보다
secretly	몰래
to gather	몰려들다
to get crowded	몰리다
bodyweight	몸무게
gesture	몸짓
very, terribly	몹시
to be ugly	못생기다
weight	무게
indifference	무관심
to collapse, to be pulled down	무너지다
pattern	무늬
(performance) stage	무대
extreme heat (in summer)	무더위
tomb	무덤
to be hot and humid	무덥다
around (the time)	무렵
safely	무사히
to be scared	무서워하다
wireless	무선
no news	무소식
disregard, neglect	무시
unmanned, no person	무인
absolutely	무조건
rainbow	무지개
electronic transfer, ATM deposit	무통장 입금
to stay (at a hotel)	묵다
to bundle, to tie	묶다
stationery	문구
civilization	문명
grammar	문법
a visit to a sick person	문병
documents	문서
inquiry	문의
SMS, short messages, letters	문자
problem	문제점
literature	문학
cultural life	문화생활
cultural heritage	문화유산
being cultural	문화적
to put on, to get buried	묻히다
price	물가
fish	물고기
Korean cold noodle	물냉면
to bite	물다
to step back, to withdraw	물러서다
to pass on, to leave	물려주다
to be stung, to get bitten	물리다
water drop	물방울
liquid medicine	물약
question	물음
quality	물질
product, goods	물품
musical	뮤지컬
to slide	미끄러지다
to be slippery	미끄럽다
to procrastinate, to extend	미루다
smile	미소
seaweed	미역
seaweed soup	미역국
barber	미용사
beautiful woman	미인
to go mad, to be crazy	미치다
blind date	미팅
an unmarried, single person	미혼
lodge, a local hotel	민박
folklore	민속
folk play	민속놀이
folk song	민요
ethnic group	민족
to believe in	믿다
trust, faith	믿음
to be reliable	믿음직스럽다
to be trustworthy	믿음직하다
to push	밀다
to rush in, to be pushed into	밀려오다
millimeter	밀리미터
to hate, to be annoying	밉다
and	및
underline	밑줄
gourd	바가지
basket	바구니
outside, outdoor	바깥
needlework	바느질
needle	바늘
bottom, floor	바닥
to run out	바닥나다
seawater	바닷물
game of go	바둑
to look at	바라보다
idiot, stupid	바보
rock, stone	바위
virus	바이러스
wheels	바퀴
background, foundation	바탕
doctoral degree, Ph.D.	박사
box	박스
to be pleased, to be glad	반가워하다
return	반납
return date	반납일
opposite	반대
opposite word	반대말
opposite side	반대쪽
without fail, certainly	반드시
casual talk	반말
repeat	반복
introspection, self-contemplation	반성
reaction	반응
shiny, sparkly	반짝반짝
to shine, to glitter	반짝이다
refund	반품
to fall in love	반하다
to accept	받아들이다
footsteps	발걸음
discovery	발견
issuance	발급
development	발달
ballet	발레
invention	발명
ankle	발목
occurrence	발생
footprints	발자국
presenter	발표자
presentation	발표회
to reveal, to disclose	밝히다
to step on	밟다
all night, during the night	밤새
to stay up all night	밤새우다
rice bowl	밥그릇
appetite, the taste of rice	밥맛
table for having a meal	밥상
just now	방금
visit	방문
broadcasting company	방송사
method, style	방식
audience	방청객
interference, interruption	방해
direction	방향
(farm) field	밭
background	배경
belly button	배꼽
backpack	배낭
backpack trip	배낭여행
consideration	배려
spouse	배우자
cabbage	배추
battery	배터리
snake	뱀
to spit out	뱉다
habit, manner	버릇
to have bad manners	버릇없다
mushroom	버섯
button	버튼
translation	번역
number ticket	번호표
fine	벌금
to open, to spread	벌리다
honeycomb	벌집
range	범위
criminal, offender	범인
crime	범죄
law	법
court of law	법원
to take off (clothes)	벗기다
to get out	벗어나다
pillow	베개
bell	벨
belt	벨트
rice plant	벼
thunder	벼락
flea market	벼룩시장
wall-hanging	벽걸이
brick	벽돌
change, alter	변경
toilet bowl	변기
excuse	변명
constipation	변비
to change	변하다
change	변화
nickname	별명
something else, something that has changed	별일
a visit to a sick person	병문안
report	보고
(written) report	보고서
reporting/briefing session	보고회
storage	보관
storage room	보관실
example, sample	보기
bonus	보너스
the feeling of reward	보람
the fifteenth day of the calendar	보름
full moon	보름달
treasure	보물
to take care of	보살피다
supplement, acupuncture medicine	보약
deposit	보증금
replenishment	보충
insurance	보험
insurance money	보험금
insurance fee	보험료
protection	보호
fortune	복
lottery	복권
the day of the year to eat nourishing food	복날
corridor, hallway	복도
copy	복사
copy machine	복사기
review	복습
stomach ache	복통
main discussion topic	본론
the original literature	본문
highlights/fun things to see	볼거리
volume	볼륨
bowling	볼링
bowling gym	볼링장
errand	볼일
volunteer	봉사
volunteer person	봉사자
to be ashamed of	부끄러워하다
to be shy, to be ashamed	부끄럽다
burden, pressure	부담
to collide	부딪치다
to get collided	부딪히다
to feel jealous	부러워하다
to get broken	부러지다
to be envious of	부럽다
part	부분
advert	부사
injury	부상
injured person	부상자
department	부서
to be shattered	부서지다
rich person	부자
side effects	부작용
rich family	부잣집
being negative	부정적
being not enough, lacking	부족
carelessness	부주의
eagerly, diligently	부지런히
fan	부채
bouquet	부케
size, volume	부피
quantity	분량
separation	분리
garbage recycling	분리수거
to be distinct, to be clear	분명하다
clearly, explicitly	분명히
loss	분실
lost and found	분실물
pink color	분홍색
impossibility	불가능
to be impossible	불가능하다
economic depression	불경기
buddhism	불교
irregularity	불규칙
firework	불꽃놀이
defective product, misconduct	불량
dissatisfaction	불만
insomnia	불면증
illegal	불법
flame, light	불빛
to be pathetic	불쌍하다
anxiety	불안
an anxious feeling	불안감
to increase, to become bigger	불어나다
to be unkind	불친절
to burn	불태우다
inconvenience	불편
complaints	불평
unnecessary	불필요
misfortune	불행
to be red	붉다
to be crowded	붐비다
baked bread with red beans inside (street food)	붕어빵
to catch	붙잡다
to get caught	붙잡히다
buffet	뷔페
brand	브랜드
brake	브레이크
blind	블라인드
blog	블로그
comparison	비교
being comparative	비교적
vinyl	비닐
to be vacant, to be empty	비다
video camera	비디오카메라
even if	비록
obesity	비만
rain and wind, typhoon	비바람
to mix, to rub	비비다
Korean style cold noodles with spicy sauce	비빔냉면
emergency medicine	비상약
cost	비용
to make something empty	비우다
visa	비자
to illuminate	비추다
vitamin	비타민
to compare	비하다
rainy road	빗길
debt	빚
light	빛
to drop	빠뜨리다
to fall in love, to sink down	빠지다
all without exception	빠짐없이
to get red	빨개지다
to be taken away	빼앗기다
to take away	빼앗다
cheek	뺨
to be obvious, to be clear	뻔하다
to extend	뻗다
to pull out, to choose	뽑다
root	뿌리
to spray, to spread	뿌리다
incident	사건
way of thinking	사고방식
being sociable	사교적
to date	사귀다
to disappear	사라지다
to capture	사로잡다
desert	사막
death	사망
the dead, casualty, victim	사망자
wife (of a boss)	사모님
office	사무소
privacy	사생활
deer	사슴
fact	사실
business	사업
usage fee	사용료
how to use	사용법
sauna	사우나
appreciation gift, gift	사은품
cyber	사이버
to be in a good relationship	사이좋다
website	사이트
circumstances, situation	사정
photo studio	사진관
photo album	사진첩
puberty	사춘기
dialect	사투리
resignation	사표
society	사회
social life	사회생활
moderator, chairperson	사회자
being social	사회적
mountain summit	산꼭대기
pile	산더미
obstetrics and gynecology	산부인과
forest fire	산불
industry	산업
walking path	산책로
to keep someone alive, to bring someone to life	살리다
living	살림
to live	살아가다
to be saved	살아나다
to survive	살아남다
to come alive	살아오다
murder	살인
slightly, quietly	살짝
to get fat	살찌다
to explore, to observe	살펴보다
to explore, to observe	살피다
life	삶
to boil	삶다
grilled pork belly	삼겹살
Korean independence movement day	삼일절
to swallow	삼키다
prize, reward	상
shopping street, shopping district	상가
to have no relation	상관없다
regardless	상관없이
prize money, reward	상금
consultation, counseling	상담
counseling room	상담실
counselor	상담원
consultant	상담자
fairly, pretty	상당히
opponent	상대
opponent	상대방
the other person	상대편
imagination	상상
imagination	상상력
rise, increase	상승
common knowledge, common sense	상식
commerce	상업
being commercial	상업적
merchant	상인
store	상점
symbol	상징
to feel cool and fresh	상쾌하다
status	상태
label	상표
gift certificate	상품권
to get rotten, to get damaged	상하다
situation, status	상황
to dawn	새다
to be new	새롭다
stepmother	새어머니
to stay overnight	새우다
cutting line/que	새치기
new year	새해
to be eccentric, to be unique, to be new	색다르다
color	색상
to remember, to recall	생각나다
ginger tea	생강차
to emerge, to occur	생겨나다
appearance	생김새
omission, deletion	생략
straight hair	생머리
life	생명
production	생산
to be fresh	생생하다
live broadcast	생중계
daily necessities	생필품
cost of living, living stipend	생활비
quality of living	생활수준
three or four	서너
to hurry, to rush	서두르다
drawer	서랍
introduction	서론
signature	서명
western	서부
serving	서빙
gradually	서서히
to be sorry, to be remorseful	서운하다
to be clumsy, to be unskilled	서투르다
master's degree	석사
dinner	석식
oil, petroleum	석유
coal	석탄
to mix, to rub	섞다
line	선
sunglasses	선글라스
to be cool, to be chilly	선선하다
developed country	선진국
order of arrival	선착순
theory	설
persuasion	설득
no way	설마
manual	설명서
questionnaire	설문조사
questionnaire	설문지
even if, for example, diarrhea	설사
to be sorry, to be regrettable	섭섭하다
success	성공
performance, function	성능
catholic church	성당
statement, signature	성명
gender	성별
diligent	성실
adult	성인
adult diseases, lifestyle diseases	성인병
grades	성적
grade report card	성적표
plastic surgery	성형
being global, being worldwide	세계적
tax	세금
century	세기
to count	세다
generation	세대
sophistication	세련
washbasin, sink	세면대
toiletries, washing accessories	세면도구
seminar	세미나
triple, 3 times	세배
new year's money	세뱃돈
world	세상
years	세월
detergent	세제
laundry	세탁물
shirt	셔츠
shuttle bus	셔틀버스
thoughts, feelings	소감
blind date	소개팅
small scale	소규모
small theater	소극장
being passive	소극적
(sudden) shower/rain	소나기
young boy	소년
income	소득
hope	소망
sleeve	소매
pickpocketing	소매치기
rumors, reputation	소문
firefighter	소방관
fire department	소방서
firetruck	소방차
consumption	소비
consumer	소비자
novel	소설책
minority, a small number	소수
sauce	소스
to be timid, to be cowardly	소심하다
way of use	소용
useless	소용없다
wish	소원
noise	소음
soju, a Korean liquor	소주
to be important	소중하다
valuably, carefully	소중히
digestion	소화
to be tricked	속다
proverb	속담
speed	속도
speed violation	속도위반
speed	속력
to be annoying, to be regretful, to be sad	속상하다
underwear	속옷
to deceive	속이다
palm	손바닥
hands and legs	손발
to be easy	손쉽다
grandson	손자
handle, rail	손잡이
trimming, repair	손질
to be honest	솔직하다
honestly, frankly	솔직히
skill, tricks	솜씨
money transfer	송금
iron	쇠
beef	쇠고기
show	쇼
shopping mall	쇼핑몰
shopping bag	쇼핑백
shopping center	쇼핑센터
pickup, collection	수거
hardship, hard work	수고
means, method	수단
water faucet	수도꼭지
quantity, amount	수량
completion ceremony	수료식
repair	수리
repair cost	수리비
sleep	수면
sleeping pills	수면제
lifespan	수명
seafood	수산물
prime minister	수상
repair (clothes)	수선
to repair (clothes)	수선하다
commission, fee, charge	수수료
import, income	수입
revision, crystal	수정
level	수준
collection	수집
export	수출
(money) check	수표
school excursion	수학여행
women's clothing	숙녀복
lodging, accomodating	숙박
accommodation fee	숙박비
accommodation	숙소
to get low, to bend low	숙이다
moment	순간
Sundubu soup	순두부찌개
drinking party	술자리
glasses, cup	술잔
bar	술집
to hide (something)	숨기다
to hide	숨다
numbers	숫자
forest	숲
buddhist monk	스님
by oneself	스스로
scanner	스캐너
style	스타일
stickers	스티커
soup	스프
speaker	스피커
slipper	슬리퍼
sorrow, sadness	슬픔
moisture	습기
humidity	습도
elevator	승강기
passenger	승객
victory	승리
passenger car	승용차
promotion	승진
riding, boarding	승차
visual sense	시각
era, generation	시대
attempt, trial	시도
sight	시력
to feel a chill, to be painfully cold	시리다
parent-in-law	시부모님
system	시스템
father-in-law	시아버지
mother-in-law	시어머니
intercity bus	시외버스
poet	시인
poetry collection, marriage (for women)	시집
to get married (for women)	시집가다
multimedia room	시청각실
audience, viewer	시청자
competition, match	시합
studying for an exam	시험공부
formula, method	식
familly	식구
grocery	식료품
plant	식물
botanical garden	식물원
food expenses	식비
diet	식생활
eating habits	식습관
appetite	식욕
cooking oil	식용유
vinegar	식초
food	식품
after a meal	식후
report	신고
to make someone wear (shoe)	신기다
new technology	신기술
to be mysterious, to be amazing, to be marvelous	신기하다
to be excited, to have fun	신나다
new city	신도시
groom	신랑
groom candidate	신랑감
newspaper company	신문사
newspaper	신문지
bride, father (christianity)	신부
identification document	신분증
new item	신상품
to be fresh	신선하다
new generation	신세대
credit, trust	신용
freshmen	신입생
new product	신제품
applicant	신청자
body	신체
new model	신형
signal	신호
newly married	신혼
newlyweds, newly-married couple	신혼부부
honeymoon	신혼여행
to put on, to pile on	싣다
yarn, thread	실
indoor	실내
ability	실력
disappointment	실망
implementation	실시
being practical	실용적
in fact, actually	실은
in fact, actually	실제
in fact, actually	실제로
disappearance, missing	실종
missing person	실종자
(put into) practice, action	실천
as much as one wants	실컷
silk	실크
failure	실패
experiment	실험
laboratory	실험실
to get sick of, to get tired of	싫증
to be serious	심각하다
to plant	심다
psychology	심리학
psychologist	심리학자
errand	심부름
to be bored	심심하다
heart	심장
heart disease	심장병
to be fresh, to be lively	싱싱하다
sink	싱크대
cheap thing	싸구려
fight	싸움
to be chilly	쌀쌀하다
twins	쌍둥이
to stack, to build	쌓다
to shoot	쏘다
to spill	쏟다
to spill, to pour, to fall heavily	쏟아지다
to be shy	쑥스럽다
to fall, to collapse	쓰러지다
trash can	쓰레기통
to be needless, to be useless	쓸데없다
uselessly, unreasonably	쓸데없이
to be lonely	쓸쓸하다
to cover	씌우다
Sireum, Korean Sumo	씨름
to be reliable, to be strong	씩씩하다
to be regrettable, to be precious	아깝다
to save, to be frugal	아끼다
announcer	아나운서
no	아니
child	아동
one's junior, one's subordinate	아랫사람
part-time job	아르바이트
Arirang (Korean traditional song)	아리랑
any, what	아무것
anyhow, whatever	아무래도
any sort of, in any way	아무런
no matter how	아무리
anyway	아무튼
frustration, regret	아쉬움
to be unsatisfied, to be sorry	아쉽다
username, ID	아이디
idea	아이디어
morning and evening	아침저녁
pain	아픔
nightmare	악몽
handshake	악수
fog	안개
ophthalmology	안과
announcement, notice	안내문
guidebook, handbook	안내서
information office	안내소
to fail, to not go well	안되다
master's bedroom	안방
news, regards	안부
complexion	안색
relief	안심
eye drop	안약
safety line	안전선
snack (served with alcoholic beverages)	안주
inside	안쪽
to feel sorry	안타깝다
to let/make someone sit down	앉히다
egg, ball	알
allergy	알레르기
to understand	알아듣다
to recognize	알아보다
to admit, to accept	알아주다
tablet medicine	알약
alcohol	알코올
cancer	암
future	앞날
to have something ahead	앞두다
before and after	앞뒤
(hair) bangs	앞머리
baby	애기
pet dog	애완견
pets	애완동물
lover	애인
love, affection	애정
after-sales service	애프터서비스
picture frame	액자
album	앨범
nighttime, during night	야간
night view	야경
overwork	야근
to be scolded	야단맞다
to scold	야단치다
outdoors	야외
picnic	야유회
to be weak	약하다
engagement	약혼
fiance	약혼자
to be calm, to be gentle	얌전하다
condiments, seasoning, spice	양념
nursing home	양로원
Yangban, nobility	양반
yielding, concession	양보
both	양쪽
this person	얘
to violate	어기다
already, so soon	어느새
to be such a one's thoughts	어떠하다
to be such a one's thoughts	어떡하다
difficulty, hardship	어려움
children	어린아이
Children's day	어린이날
Parent's day	어버이날
to be awkward	어색하다
anyway	어쨌든
coincidentally	어쩌다가
maybe, possibly	어쩌면
somehow	어쩐지
after all, any way	어차피
language	어학
language training	어학연수
vocabulary	어휘
billion	억
accent	억양
forcibly	억지로
mass media	언론
journalist	언론인
language	언어
someday	언젠가
to obtain	얻다
to get treated	얻어먹다
to freeze	얼다
stain	얼룩
to be fast, to be quick	얼른
to be strict	엄격하다
to be tremendous, to be enormous	엄청나다
work, job	업무
to get rid of, to dispose of	없애다
butt	엉덩이
to be strange, to be bizarre	엉뚱하다
wreck, mess, ruin	엉망
a few days ago	엊그제
energy	에너지
aids	에이즈
engine	엔진
membership training	엠티
leisure	여가
high school girl	여고생
hotel, inn	여관
acne	여드름
many	여럿
summer day	여름날
female	여성
women's clothing	여성복
spare, margin	여유
just as it was before	여전히
to ask politely	여쭈다
travel expenses	여행비
traveler	여행자
travel destination	여행지
being historical	역사적
as expected, after all	역시
role	역할
connection	연결
research	연구
research institute	연구소
research laboratory	연구실
theater	연극
delay, postponement, smoke, acting	연기
year	연도
communication	연락
end of the year	연말
new years holidays	연말연시
seniority, elder	연상
continuity	연속
serial drama, soap opera	연속극
training	연수
romance, courtship	연애
love marriage	연애결혼
couple	연인
extension	연장
performance	연주
concert	연주회
being a younger, younger person	연하
to be soft, to supple	연하다
annual fee	연회비
a very hot night	열대야
reading room	열람실
10 days	열흘
dyeing	염색
(Korean traditional) candy	엿
receipt	영수증
nutrition	영양
nutritional value	영양가
nutrients	영양분
nutrients	영양소
nutritional supplement	영양제
sales	영업
sales department	영업부
area	영역
eternally, everlastingly, forever	영원히
impact	영향
film director	영화감독
film festival	영화제
a neighbor, the house next door	옆집
(bank) deposit	예금
reservation, booking	예매
prevention	예방
forecast	예보
expectation	예상
art	예술
pre-view, preparation	예습
wedding hall	예식장
manner, etiquette	예의
past, old days	예전
manner, etiquette	예절
plans	예정
forecast	예측
old, ancient	옛
old story, old speech, old tale	옛말
to come and go	오가다
today	오늘날
entertainment	오락
to be old	오래되다
long time	오랜
to go up and down	오르내리다
right hand	오른손
orientation	오리엔테이션
pollution	오염
motorcycle	오토바이
opera	오페라
officetel(office + hotel)	오피스텔
misunderstanding	오해
rather	오히려
all~, entire	온
various kinds of	온갖
temperature	온도
Ondol (Korean traditional heating system)	온돌
room with Ondol	온돌방
online	온라인
whole-body	온몸
hot spring	온천
hot spring bath	온천욕
all, entire	온통
to raise, to post	올리다
olympic	올림픽
to be proper, to be honest	올바르다
to be correct	옳다
dress, clothing	옷차림
wine	와인
completion	완성
completely	완전히
king	왕
round trip	왕복
queen	왕비
for some reason	왠지
maternal	외가
surgery department	외과
diplomat	외교관
only daughter	외동딸
only son	외동아들
loan word, borrowed word	외래어
loneliness	외로움
appearance	외모
eating out	외식
only son	외아들
to memorize	외우다
to scream, to shout	외치다
yoga	요가
request	요구
yogurt	요구르트
recipe	요리법
chef	요리사
recently, these days	요새
summary	요약
request	요청
abusive language	욕
bathroom	욕실
greed	욕심
greedy person	욕심쟁이
dragon	용
courage	용기
pocket money, allowance	용돈
forgiveness	용서
honor prize	우등상
Korean language	우리말
well	우물
excellence	우수성
victory, championship	우승
to be graceful	우아하다
chance, accident	우연
coincidentally	우연히
depression	우울증
to be depressed	우울하다
friendship	우정
space	우주
space travel	우주여행
post	우편
post mail	우편물
mail delivery	우편배달
luck	운
fate	운명
driver	운전기사
driver's license	운전면허
driver	운전자
crybaby	울보
crying, tear	울음
superior, senior	웃어른
laughter	웃음
very, basically	워낙
manuscript	원고
originally	원래
studio apartment	원룸
principle	원리
application	원서
monkey	원숭이
cause	원인
end of month	월말
wedding dress	웨딩드레스
to be great	위대하다
consolation, comfort	위로
violation	위반
superior, senior	윗사람
outstandingly, especially	유난히
uniform	유니폼
cruise ship	유람선
being paid, being charged	유료
window glass	유리창
humor	유머
being famous	유명
historic site	유적지
to be fluent	유창하다
kindergarten	유치원
to be fun, to be cheerful	유쾌하다
buzzword	유행어
being carnivorous	육식
childcare	육아
game of Yut, Yunnori	윷놀이
silver	은
favor, grace	은혜
lunar calendar	음력
beverages, drink	음료
voice	음성
food and drink	음식물
restaurant	음식점
musical concert	음악회
drinking	음주
emergency room	응급실
response, answer	응답
respondents	응답자
examinee	응시자
cheering, support	응원
opinion	의견
consultation, discussion	의논
clothing	의류
obligation	의무
question	의문
communication	의사소통
clothing, costume	의상
clothing, food, and housing	의식주
doubt	의심
unexpectedly	의외로
motivation	의욕
significance, meaning, sense	의의
will	의지
to be based on	의하다
(field of) medicine	의학
being medical	의학적
this and that, various, everything	이것저것
being exotic, being foreign	이국적
to win	이기다
being selfish	이기적
to pull, to guide	이끌다
soon	이내
is	이다
move	이동
later	이따
at this time	이때
such, of this kind, of this sort	이러하다
this and that, various	이런저런
to accomplish, to achieve, to compose	이루다
to be achieved, to be composed of	이루어지다
to become famous	이름나다
name tag	이름표
this way	이리
here and there	이리저리
forehead	이마
this much of, at here	이만
this much	이만큼
already	이미
image	이미지
immigrants	이민
farewell	이별
blanket	이불
otorhinolaryngology, ENT	이비인후과
belongings when moving house	이삿짐
an ideal type of person	이상형
reason, the opposite sex	이성
to be connected	이어지다
earphone	이어폰
except, besides	이외
usage fee	이용료
user	이용자
neighborhood	이웃
neighbor	이웃집
profit	이익
interest	이자
before	이전
finally now	이제야
less than, below	이하
comprehension, understanding	이해력
compassion, understanding	이해심
divorce	이혼
afterward	이후
well-known, familiar	익숙하다
to boil, to learn	익히다
human	인간
relationships	인간관계
human nature	인간성
being human	인간적
human race	인류
greeting words	인사말
being impressive	인상적
life	인생
printing	인쇄
printed papers	인쇄물
instant food	인스턴트
number of people	인원
to be recognized, to be accepted	인정받다
ATM	인출기
intern	인턴사원
to result from, to be caused by, to be due to	인하다
diary	일기장
first of all, firstly	일단
first place	일등
ordinary	일반
ordinary people	일반인
being ordinary	일반적
part	일부
on purpose	일부러
daily life	일상
being daily	일상적
lifetime	일생
temporary	일시
lump-sum payment	일시불
to raise, to sit upright	일으키다
workplace	일자리
schedule	일정
to be uniform, to be constant	일정하다
sunrise	일출
disposable product	일회용품
to be read	읽히다
pregnant woman	임산부
temporary	임시
pregnancy	임신
deposit, payment on account	입금
appetite	입맛
lips	입술
entrance examination	입시
admission	입장
admission ticket	입장권
admission fee	입장료
entrance examination	입학시험
to dress someone up	입히다
to connect, to tie, to continue	잇다
leaf	잎
qualification	자격
license, certificate	자격증
being provocative, being stimulating	자극적
frequently	자꾸
child	자녀
automatic	자동
to grow up	자라다
boast, brag, showing off	자랑
archive, reference room	자료실
subtitles	자막
sisters	자매
suicide	자살
to be detailed, to be minute	자세하다
in detail	자세히
child, kid	자식
confidence	자신감
being natural	자연적
ultraviolet rays	자외선
resource	자원
consonant	자음
self-esteem, pride	자존심
living alone	자취
vending machine	자판기
writer	작가
composition	작곡
essay, writing	작문
writing lyrics	작사
to get smaller	작아지다
work, job, operation	작업
work, piece	작품
small money, small change	잔돈
grass	잔디
grass field	잔디밭
full, much	잔뜩
useless talk, idle talk	잔소리
balance	잔액
to lock (a door)	잠그다
to get locked, to submerged	잠기다
to fall asleep	잠들다
pajama	잠옷
dragonfly	잠자리
to eat (honorific)	잡수다
to prey on, to feed on	잡아먹다
Japchae (Korean food)	잡채
to get caught	잡히다
marriage (of men)	장가
to get married (of men)	장가가다
being long term	장기적
naughty, prank	장난
toy	장난감
mischievous kid	장난꾸러기
eldest son	장남
eldest daughter	장녀
advantages and disadvantages	장단점
future	장래
funeral	장례식
funeral hall	장례식장
shopping basket	장바구니
business	장사
disability	장애
disabled people	장애인
scholarship	장학
scholarship	장학금
reissue	재발급
wealth, property	재산
two years ago	재작년
talent, skills	재주
jazz	재즈
investment techniques	재테크
enrollment	재학
disaster	재해
remarriage	재혼
recycling	재활용
recycled goods	재활용품
that person	쟤
savings	저금
piggybank	저금통
to be cheap	저렴하다
scale (weight)	저울
storage, preservation	저장
being natural, being automatic	저절로
savings	저축
being enthusiastic, being active	적극적
installment savings	적금
to be appropriate	적당하다
appropriately	적당히
aptitude (for)	적성
at least	적어도
to get less	적어지다
adaptation	적응
to be suitable	적절하다
light bulb	전구
nationwide	전국
being national	전국적
electricity	전기
the day before	전날
delivery, conveyance	전달
subway train	전동차
lamp, light	전등
outlook	전망
expert	전문가
being professional	전문적
specialty shop	전문점
first half	전반전
all, entire	전부
computer room	전산실
security deposit system of housing	전세
rent house	전셋집
exhibition	전시
exhibition	전시회
power supply	전원
electron	전자
microwave	전자레인지
war	전쟁
subway, train	전철
entire	전체
being overall	전체적
tradition	전통
traditional culture	전통문화
being traditional	전통적
phone bell	전화벨
definitely, absolutely	절대로
half	절반
saving, frugality	절약
young people	젊은이
youth	젊음
to be well-mannered, to be gentle	점잖다
gradually, slowly	점점
gradually	점차
to fold, to quit	접다
reception	접수
to encounter, to come into contact	접하다
affection	정
being regularly	정기적
correct answer	정답
really	정말로
informatization	정보화
government	정부
normal	정상
being normal	정상적
sincerity, devotion	정성
with one's whole heart, elaborately	정성껏
mind, consciousness	정신
to be not in one's right mind	정신없다
hectically, frantically	정신없이
being mental	정신적
justice	정의
formal clothes, suits	정장
power outage	정전
stop	정지
to be honest	정직하다
stopping	정차
identity	정체
politics	정치
politician	정치가
politician	정치인
political science	정치학
to be accurate	정확하다
accurately	정확히
to get wet, to get soaked	젖다
offer	제공
properly	제대로
system	제도
on time	제때
please	제발
swallow	제비
ancestral rites, memorial service	제사
on time	제시간
suggestion	제안
student, disciple, follower	제자
original place	제자리
production	제작
submission	제출
product	제품
limit, restriction	제한
shellfish	조개
conditions	조건
assistant	조교
jogging	조깅
to tighten, to pester	조르다
cooking	조리
recipe	조리법
braised dish	조림
sooner or later	조만간
lighting, illumination	조명
seasoning	조미료
ancestor	조상
caution, carefulness	조심
adjustment	조절
pig's feet	족발
respect	존경
to doze	졸다
to be sleepy	졸리다
graduation ceremony	졸업식
sleepiness	졸음
easily, anytime soon	좀처럼
to narrow, to make something smaller	좁히다
religion	종교
paper cup	종이컵
from time to time, sometimes	종종
total, comprehensive	종합
seat	좌석
left and right	좌우
turn left	좌회전
residence	주거
to exchange	주고받다
anniversary/annual~	주년
wrinkles	주름
fist	주먹
purchase order	주문서
resident	주민
kitchen	주방
corporation	주식회사
to be given	주어지다
gas station	주유소
caution	주의
main character	주인공
assertion, captain	주장
subject, theme	주제
housing, residence	주택
residential area	주택가
death	죽음
to kill	죽이다
belongings	준비물
story, plot	줄거리
striped pattern	줄무늬
to decrease	줄어들다
to reduce, to shrink	줄이다
to pick up	줍다
middle	중간
agency	중개소
second hand	중고
second-hand car	중고차
second-hand goods	중고품
intermediate	중급
suspension	중단
central part	중부
small and medium-sized enterprises	중소기업
capital, hub	중심지
central part	중앙
importance	중요성
mouse	쥐
that is, which means	즉
joy, pleasure	즐거움
growth, rise	증가
certificate	증명서
symptoms	증상
to get tired, to get bored	지겹다
earth	지구
to pass by	지나가다
to be extreme, to be severe	지나치다
last year	지난해
to be boring	지루하다
roof	지붕
knowledge	지식
area	지역
hell	지옥
to erase	지우다
support	지원
supporter	지원자
status	지위
to be messy, to be dirty	지저분하다
point, branch	지점
earthquake	지진
expense, spending	지출
to be tired, to be exhausted	지치다
to watch, to take care	지켜보다
zipper	지퍼
conductor	지휘자
straight line	직선
worker	직장인
being direct	직접적
going straight	직진
immediately after	직후
truth	진실
sincerity	진심
really, truly	진짜
medical examination	진찰
painkiller	진통제
to be thick, to be dark	진하다
entrance to a higher educational institution	진학
progress	진행
chairperson	진행자
disease	질병
order	질서
jealousy	질투
disease	질환
beast	짐승
house price	집값
to grab	집다
housewarming party	집들이
rent	집세
family	집안
housework	집안일
landlord	집주인
concentration	집중
concentration	집중력
to be thick, to be dark	짙다
frustration	짜증
pair	짝
crush, one side love	짝사랑
even number	짝수
to be chased	쫓기다
to chase	쫓다
to kick out	쫓아내다
to chase around	쫓아다니다
all the time	쭉
to get fat	찌다
sauna	찜질
humid heat	찜통더위
to break, to tear	찢다
to be torn, to be ripped	찢어지다
rather	차라리
order	차례
to be calm, to be quiet	차분하다
difference	차이
differences	차이점
misunderstanding	착각
cold water	찬물
agreement	찬성
participation	참가
reference	참고
sesame oil	참기름
to endure	참다
attendance, participation	참석
participation	참여
tuna	참치
café, teahouse	찻집
window	창
shame, embarrassment	창피
to find out	찾아내다
to search around	찾아다니다
to look for	찾아보다
channel	채널
vegetarian	채식
vegetarian person	채식주의자
recruitment	채용
to satisfy, to fill in	채우다
online chat	채팅
to be in charge, to be responsible	책임지다
to pack, to prepare	챙기다
virgin	처녀
processing	처리
prescription	처방
prescription	처방전
heaven	천국
angel	천사
ceiling	천장
genius, natural disaster	천재
philosophy	철학
first day	첫날
first snow	첫눈
first love	첫사랑
first impression	첫인상
invoice	청구서
youth	청년
teenager	청소년
invitation	청첩장
marriage proposal	청혼
build, frame	체격
body temperature	체온
physical education	체육
gym	체육관
gymnastics	체조
bodyweight	체중
experience	체험
to stare, to look up	쳐다보다
beginner-level	초급
beginning, start	초기
invitation	초대장
beginner	초보자
invitation	초청장
gun	총
general affairs division	총무과
studio	촬영장
filming site	촬영지
recent	최근
maximum	최대
best	최선
latest	최신
minimum	최저
last, final	최종
the first	최초
last, final	최후
adding	추가
cold	추위
recommendation	추천
letter of recommendation	추천서
drawing lots	추첨
guess	추측
leaving a country	출국
on the way to work	출근길
output	출력
giving birth	출산
birth rate	출산율
birth	출생
attendance	출석
origin, affiliation	출신
access, enter	출입
immigration	출입국
commuting	출퇴근
publishing company	출판사
shock, impact	충격
advice	충고
collision	충돌
enough	충분하다
enough, sufficiently, fully	충분히
　　	취업
unemployment crisis	취업난
sleeping, going to bed	취침
to get drunk	취하다
~side	측
treatment medicine	치료제
size, measurement	치수
to clean up, to remove	치우다
cheese	치즈
biological mother	친어머니
being eco-friendly	친환경
saliva	침
bedroom	침실
compliment	칭찬
carnation	카네이션
cassette	카세트
car repair shop	카센터
caffeine	카페인
carpet	카펫
column, blank	칸
Korean style noodle	칼국수
to be very dark, to be pitch-dark	캄캄하다
campus	캠퍼스
camping	캠프
to be extremely big	커다랗다
to get bigger, to grow	커지다
curtain	커튼
couple	커플
computer room	컴퓨터실
to light up	켜지다
elephant	코끼리
corner	코너
comedy	코미디
comedian	코미디언
concert	콘서트
electrical outlet, socket	콘센트
bean sprouts	콩나물
quiz	퀴즈
main road	큰길
big money	큰돈
big voice, loud voice	큰소리
important matter	큰일
classic	클래식
click	클릭
to nurture, to make it bigger	키우다
type	타입
mask, disguise	탈
dressing room, fitting room	탈의실
Korean traditional mask dance	탈춤
boarding gate	탑승구
soup, juice	탕
attitude	태도
sun	태양
solar heat	태양열
to burn, to bake	태우다
delivery	택배
delivery fee	택배비
to burst, to happen suddenly	터지다
to shake off	털다
tape	테이프
tent	텐트
rabbit	토끼
discussion	토론
to vomit	토하다
statistics	통계
communication	통신
interpretation	통역
unification	통일
pain	통증
notice	통지서
phone call	통화
way back from home	퇴근길
being discharged from hospital	퇴원
retirement	퇴직
vote	투표
to fry, to bounce	튀기다
truck	트럭
specialty	특기
being special	특별
to be special	특별하다
specialty, regional product	특산물
to be durable, to be strong	튼튼하다
to be sure enough	틀림없다
definitely	틀림없이
crack, gap	틈
ticket	티켓
team leader	팀장
to dig down, to carve	파다
perm	파마
file	파일
Korean pancake	파전
sale	판매
seller	판매자
Korean style shaved ice	팥빙수
fashion show	패션쇼
fast food	패스트푸드
fax	팩스
fan	팬
to spread	퍼지다
convenience	편리
unbalanced diet	편식
to be comfortable	편안하다
convenience store	편의점
easily	편히
to spread	펼치다
evaluation	평가
average	평균
equal	평등
to be ordinary, to be usual, to be common	평범하다
forever	평생
usual day	평소
peace	평화
to be cozy	포근하다
to give up	포기
wine	포도주
point	포인트
wrapping paper	포장지
explosion	폭발
heavy snow	폭설
binge eating	폭식
heavy rain	폭우
waterfall	폭포
sign, mark	표시
facial expression	표정
display board	표지판
to be blue	푸르다
to be untied, to be relieved	풀리다
interpretation	풀이
quality	품질
landscape	풍경
to be rich, to be abundant	풍부하다
balloon	풍선
frying pan	프라이팬
programmer	프로그래머
printer	프린터
plastic	플라스틱
plug	플러그
fatigue	피로
skin	피부
dermatology	피부과
skin disease	피부병
summer vacation	피서
pianist	피아니스트
to avoid	피하다
damage	피해
victim	피해자
mandatory	필수
necessities	필수품
necessity	필요성
excuse	핑계
too, excessively	하도
as soon as possible, immediately, quickly	하루빨리
day by day	하루하루
one night	하룻밤
almost, nearly	하마터면
yawn	하품
department (at university)	학과
educational background	학력
academic field	학문
tuition fee	학비
learning, study	학습
scholar	학자
grade, credit	학점
to be leisurely, to be relaxed	한가하다
Korean studies	한국학
Hangul day	한글날
at once, together	한꺼번에
midday	한낮
at a glance	한눈
temporarily, for a while	한동안
one or two	한두
a word	한마디
for a moment	한순간
sigh	한숨
acupuncture medicine	한약
Hanok (traditional Korean architecture)	한옥
Korean beef	한우
doctor of traditional Korean medicine	한의사
Korean set meal	한정식
traditional Korean paper	한지
for a long time	한참
at its peak, in bloom	한창
on the other hand	한편
monthly installment plan	할부
discount store	할인점
thoughtlessly, mindlessly	함부로
successful candidate, winner	합격자
to sum, to match	합치다
to add	합하다
flight	항공
flight ticket	항공권
aircraft	항공기
airfare	항공료
airlines	항공사
flight	항공편
solution	해결
solution	해결책
layoff, discharge	해고
to accomplish, to achieve	해내다
sunrise	해돋이
to be harmful	해롭다
annual, every year	해마다
seafood	해물
to try, to attempt	해보다
seafood	해산물
solution	해소
solution	해소법
sea bathing	해수욕
beach	해수욕장
antipyretic	해열제
handbag	핸드백
new grain	햇곡식
sunlight	햇볕
action, behavior	행동
event hall	행사장
luck, fortune	행운
scent	향
fragrance	향기
perfume, nostalgia	향수
to head	향하다
permission	허락
belt, waistband	허리띠
to be rough	험하다
to wander, to get lost	헤매다
hairstyle	헤어스타일
to break up, to leave	헤어지다
to swim	헤엄치다
helmet	헬멧
sports club, gym	헬스클럽
entrance	현관
entrance door	현관문
present-day	현대
modern style	현대식
modern people	현대인
being modern	현대적
wise mother and good wife	현모양처
reality	현실
being realistic	현실적
on-site	현장
adjective	형용사
form	형태
situation, circumstances	형편
grace, blessing	혜택
favor	호감
curiosity	호기심
lake	호수
name	호칭
maybe	혹시
or	혹은
to get angry	혼나다
to scold	혼내다
confusion, mess, disorder	혼잡
odd number	홀수
public relations	홍보
promotion materials	홍보물
flood	홍수
to be fancy	화려하다
screen	화면
cargo	화물
flowerpot	화분
volcano	화산
burn, scald	화상
toilet paper	화장지
fire	화재
to be fine, to be clear, to be bright	화창하다
reconciliation, settlement, compromise	화해
to be sure	확실하다
environment	환경
ventilation	환기
refund	환불
being fantastic	환상적
farewell party	환송회
welcome party	환영회
exchange rate	환율
currency exchange	환전
seasonal change	환절기
activities	활동
being active	활동적
to be active	활발하다
utilization	활용
in full bloom	활짝
to be absurd, to be nonsensical, to be ridiculous	황당하다
yellow dust, asian dust	황사
~ times	～회
one's 60th birthday	회갑
recovery	회복
membership fee	회비
group dinner, drinking party	회식
member	회원
conference hall	회의장
president	회장
number of times	횟수
effect	효과
being effective	효과적
devoted daughter	효녀
being efficient	효율적
back gate	후문
later half	후반
second half	후반전
candidate	후보
dessert	후식
regret	후회
training	훈련
to be great, to be excellent	훌륭하다
to steal	훔치다
much, far, a lot	훨씬
gasoline	휘발유
holiday season	휴가철
break-out room, lounge	휴게실
mobile	휴대
mobile phone	휴대폰
rest	휴식
resort	휴양지
leave of absence (from school)	휴학
to flow, to run	흐르다
to shake	흔들다
to wave, to shake	흔들리다
to be common	흔하다
commonly, often	흔히
to spill, to shed	흘리다
soil	흙
smoking	흡연
interest	흥미
excitement	흥분
to be white	희다
hope	희망
applicant	희망자
victim	희생자
with all one's strength	힘껏
