abandoned	заброшенный
abandon	отказываться, покидать, прекращать
abate	уменьшить
abbey	Аббатство
abbreviation	сокращение
ABC	алфавит, азбука, букварь, начатки, основы
abide	ждать, терпеть
ability	способность (-y не от слова capable)
able	способный (-e)
aboard	на корабле, на борту, в вагоне
abode	местопребывание, жилище (не lodge)
abominable	отвратительный, противный
about	о
above	над, выше, наверху
abroad	за границей
abruptly	внезапно, резко, грубо
abrupt	резкий, внезапный, крутой, обрывистый
absence	отсутствие
absent	отсутствующий
absolutely	абсолютно, совершенно
absolute	совершенный, чистый
absorbed	увлечённый чем-либо
absorb	поглощать, всасывать, впитывать
absorption	Поглощение
abstract	отвлеченный, абстрактный
absurdity	нелепость
absurd	нелепый
abundance	богатство, изобилие
abundant	обильный
acacia	акация
accent	подчеркивать, произносить
accepted	принятый
accept	принимать
accessible	доступный
access	доступ, подход, доступность
accidentally	случайно, нечаянно
accidental	случайный, нечаянный
accident	несчастный случай
acclaim	провозглашать
accommodate	согласовывать, улаживать, примирять
accommodation	удобство, согласование
accompanying	сопровождающий
accompany	сопровождать
accomplice	сообщник
accomplished	Выполненный
accomplish	выполнять
accordance	согласованность, согласие, соответствие
accordingly	согласно
according	согласно
accord	согласие, гармония
accounts	счета
account	счет, оценка, причина
accuracy	точность, аккуратность
accurate	точный, правильный
accusation	обвинение
accused	обвиняемый
accuse	обвинять
accustomed	приученный
accustom	приучать
ache	боль
achievement	выполнение, достижение
achieve	достигать, успешно выполнять
acid	кислый, кислота (не sour)
acknowledged	подтвержденный
acknowledge	признавать, вознаграждать
acorn	желудь
acquaintance	знакомство, знакомый
acquired	приобретённый
acquire	приобретать
acquisition	приобретение
acquit	оправдывать
across	через
acted	действовал
acting	временно исполняющий обязанности, игра
action	действие, поступок
actively	активно, деятельно
active	активный
activity	деятельность, активность
actor	актер
actor	актер
actress	актриса
acts	действия
actually	фактически, в настоящее время
actual	текущий, современный
act	акт, дело, действовать
acute	острый, проницательный
adapted	Приспособленный
adapt	приспособить, переделать
additional	дополнительный
additions	Дополнения
addition	прибавление, сложение
address	адрес, обращение
add	добавлять, прибавлять
adept	знаток, сторонник
adequate	достаточный, соответствующий
adhere	прилипать, приставать ( to) , приклеиваться, хвататься
adjoining	смежный
adjustment	регулирование
adjust	регулировать, приспосабливать
administration	администрация
administrator	администратор
admirable	замечательный (не wonderful)
admiral	адмирал
admiration	восхищение
admired	восхищался (от admire)
admire	восхищаться
admiring	восхищающийся
admission	допуск, вход, прием
admittance	впуск, доступ
admitted	признанный(допущенный) 
admit	допускать
adopted	принятый 
adopt	принимать, присваивать
adore	обожать
adorn	украшать
adrift	по течению, по воле волн
ads	реклама
adults	взрослые (от adult)
adult	взрослый
advanced	передовой
advance	продвижение вперед, продвигать
advancing	продвижение
advantages	преимущества 
advantage	преимущество, выгода
adventurer	искатель приключений, авантюрист
adventure	рисковать, отваживаться
adventurous	отважный, предприимчивый (не undertaking)
adversary	противник
adversity	бедствие, несчастье
advertisement	объявление, реклама
advertise	помещать объявление, рекламировать
advice	cовет
advised	рекомендованный 
advise	советовать
advocate	отстаивать, защищать
aerial	воздушный, антенна
aeroplane	самолет
afar	далеко, вдали
affairs	делишки ((!NEW!))
affair	дело, занятие
affected	пораженный
affectionately	нежно 
affectionate	любящий, нежный
affections	привязанности 
affection	привязанность, любовь
affect	влиять, трогать, вредить
affirmative	утвердительный
afforded	предоставляемый
afford	позволить себе
affray	пугать
afore	перед
afraid	испуганный
afresh	снова, опять
afternoon	время после полудня
afterwards	впоследствии, позже
afterward	позже 
after	после
against	против
again	снова
aged	старый, в возрасте
agency	агентство
agent	деятель, исполнитель
age	век, возраст
aggregated	соединенный 
aggregate	совокупность
aggregation	скопление 
agitated	взволнованный (не thrilled)
agitation	агитация
agony	мучение, сильная боль
agreeable	приятный, милый
agreed	согласился (от agree)
agreement	согласие, соглашение
agree	соглашаться
agricultural	сельскохозяйственный
agriculture	сельское хозяйство
aha	ага 
ahead	вперед
aid	помощь
aileen	Эйлин 
ailing	больной
aim	целиться, цель
airborne	авиационный
airliner	лайнер
airport	аэропорт
air	воздушный, авиационный, проветривать
ajar	приоткрытый
alarm	тревога, (вс)тревожить (alarm)
alas	увы 
albert	альберт 
album	альбом
alec	алек 
alert	бдительный, проворный
alexis	алексис 
alfred	альфред 
Aliases	псевдонимы 
alias	псевдоним 
alibis	алиби 
alibi	алиби 
alight	выходить, спускаться
alignment	выравнивание, линия
alike	похожий
alive	живой
allegiance	преданность, верность
allen	аллен 
alley	аллея, переулок
allied	союзный, родственный
allocate	предназначать
allocation	распределение, назначение
allowance	дозволение, допущение (allowance)
allowing	разрешение
allows	позволяет 
allow	разрешать, разрешить
alloy	примесь, сплав
alluded	ссылался 
ally	союзник, соединять
all	все, весь
almond	миндаль, миндалина
almost	почти, едва не
aloft	наверху, наверх
alone	один, одинокий
alongside	рядом
along	вдоль
aloud	громко, вслух
alphabet	алфавит, азбука
already	уже
also	тоже, также
alteration	изменение, перемена
altered	измененный (не changed) 
alternate	переменный
alternative	альтернатива, выбор
alter	изменять
although	хотя
altitude	высота (не highness)
altogether	всего, в общем
always	всегда
amateur	любитель
amazed	изумлённый, поражённый (не wonder) ((!NEW!))
amazement	удивление, изумление
amazing	удивительный
amber	янтарь, янтарный
ambiguous	двусмысленный
ambition	честолюбие, желание
ambitious	честолюбивый
ambulance	полевой госпиталь, карета скорой помощи
amends	возмещение
amiable	любезный, милый
amid	между, посреди, среди ((!NEW!))
ammonia	аммиак
ammunition	боеприпасы
amongst	среди 
among	среди (не midst)
amorous	влюбленный, любовный
amount	количество, сумма, составлять (сумму)
ample	обширный, просторный
amusement	забава, развлечение
amuse	забавлять, развлекать
amusing	забавный, интересный
amy	Эми 
am	(я) есть (от be)
analogous	аналогичный 
analyse	анализировать, разбирать
analysis	анализ
ana	сборник изречений
ancestor	предок
anchor	якорь
ancient	древний
and	и
anew	снова, заново
angela	анжела 
Angeles	анхелес 
angel	ангел
anger	гнев, злость
angles	углы 
angle	угол, точка зрения
angrily	сердито (!NEW!)
angry	сердитый
anguish	страдание
animal	животное
animated	оживленный, анимированный
ankle	щиколотка, лодыжка
anna	анна 
Anne	Энн 
annihilation	уничтожение
anniversary	годовщина
announced	объявлял, объявленный (от announce)
announcement	объявление, сообщение
announce	объявлять
annoyance	раздражение 
annoy	досаждать, надоедать
annually	ежегодно
annual	годовой, ежегодный, ежегодник (не yearly)
anomaly	аномалия
anonymous	анонимный
another	еще один, другой
answered	ответил (от answer)
answer	ответ, отвечать
Antarctic	антарктический
anthony	Энтони 
anticipated	ожидаемый 
anticipate	предвидеть
antidote	противоядие
antique	древний (не ancient)
antiquity	древность
antony	Энтони 
ant	муравей
anvil	наковальня
anxiety	тревога, беспокойство
anxiously	тревожно ((!NEW!))
anxious	беспокойный
anyhow	во всяком случае
anyone	любой, всякий( утв предлож), кто-нибудь, никто (в отриц предлож)
anyway	во что бы то ни стало
anywhere	где-нибудь
an	неопределенный артикль (перед гласным звуком)
apartment	квартира
apartment	квартира
apart	в стороне, отдельно (не aside)
apes	обезьяны 
apex	верхушка, вершина (не peak)
ape	обезьяна (человекообразная)
apiece	за штуку, поштучно
apologies	извинения (от apology)
apologize	извиняться
apology	извинение
appalling	ужасный, плачевный
apparatus	аппарат
apparel	одевать, наряжать
apparently	явно, очевидно
apparent	видимый, очевидный
appeal	апелляция, апеллировать (юр.), обращаться
appearance	появление, внешность
appeared	появился (от appear)
appears	появляется 
appear	появляться
appendix	приложение, аппендикс (анат.)
appetite	аппетит, охота, желание
applause	аплодисменты
apples	яблоки (от apple)
Applet	апплет 
apple	яблоко
applications	заявления(применения) 
application	заявление, применение
applied	прикладной
apply	обращаться, применять
appointed	назначенный 
appointment	условленная встреча
appreciate	оценивать
approach	приближаться, подступ
approbation	одобрение (не approvement)
appropriate	подходящий, соответствующий
approval	одобрение
approve	одобрять
approximately	приблизительно
approximate	приблизительный
app	приложение 
apricot	абрикос
April	апрель
apron	фартук
apt	подходящий, уместный, склонный
arable	пахотный
arbitrary	произвольный
arbour	беседка, дерево, ось
arcadia	аркадия 
archaic	устарелый, архаический
arched	арочный 
archie	арчи 
archipelago	архипелаг 
architecture	архитектура
architect	архитектор
arch	арка, дуга
arctic	полярный, арктический
arc	дуга (мат.)
ardent	пылкий
ardour	жар, пыл, рвение
arduous	тяжелый, напряженный
area	площадь, район
are	есть (от be)
argue	спорить
arguments	аргументы(споры) 
argument	спор
arid	сухой, засушливый
arise	возникать, появляться
arithmetic	арифметика
armament	вооружение
armed	вооруженный
armies	армии 
armour	броня
arms	оружие
army	армия
arm	рука
arose	возник, появился ((!NEW!))
around	вокруг, по
aroused	разбуженный ((!NEW!))
arouse	будить, пробуждать
arrangements	меры (не measurements) 
arrangement	договоренность
arrange	устраивать, договариваться
array	массив, множество, наряжать, украшать
arrested	арестованный 
arrest	арестовывать, арест
arrival	прибытие
arrived	приехал, прибыл (от arrive)
arrive	приезжать
arriving	прибывающий
arrow	стрела
arson	поджог
artful	хитрый, ловкий
articles	предметы (от article)
article	статья, предмет, изделие
artificial	искусственный
artillery	артиллерия
artistic	художественный
artist	художник
arts	искусства 
Art	искусство
asa	аса 
ascent	восхождение, подъем
ascertained	установленный 
ascertain	установить, удостовериться
ashamed	пристыженный (!NEW!)
ashes	пепел 
ashore	на берег
ash	ясень
Asia	азия 
aside	в сторону
asked	просил, требовал (от ask)
asking	спрашивающий, просящий
asks	спрашивает (от ask)
ask	просить, спрашивать
asleep	спящий (не sleepy)
aspect	взгляд, точка зрения
assassination	убийство
assault	нападать, нападение
assembled	собранный 
assemble	созывать
assembly	собрание, ассамблея
asserted	утвержденный (не attested) 
asset	имущество
assigned	назначенный 
assignment	назначение
assign	назначать
assistance	помощь
assistant	помощник
assisted	помогал 
assist	помочь, помогать
associate	соединять, присоединять
association	ассоциация, соединение
assortment	выбор, ассортимент
assumed	принятый (не adopted) 
assume	принимать на себя
assumption	предположение
assurance	заверение, уверенность
assured	уверенный, застрахованный (!NEW!)
assure	уверять, обеспечивать
ass	осел (библ.)
asterisk	звездочка
astonished	удивленный (!NEW!)
astonishing	удивительный
astonishment	удивление, изумление
astronomy	астрономия
as	как, так, в то время как
ate	ел, съел (от eat)
athlete	спортсмен, атлет
athletics	атлетика
athwart	через, вопреки (не through)
atlas	атлас
atmosphere	атмосфера
atmospheric	атмосферный
atom	атом
attached	приложенный (не embedded) 
attachment	привязанность, прикрепление
attach	придавать
attacked	атакованный 
attacks	нападения 
attack	нападение, наступать
attempting	попытка
attempts	попытки 
attempt	пробовать, пытаться, попытка
attendance	присутствие, аудитория
attendants	дежурные 
attendant	служитель, слуга
attended	обслуженный, обслужил (от attend)
attending	посещение(сопровождение)
attend	посещать, обслуживать
attentions	внимание 
attention	внимание
attentive	внимательный, заботливый
attest	удостоверять
attic	чердак
attire	украшение, наряд
attitude	позиция, отношение, поза
attorney	адвокат, поверенный (не advocate)
attraction	привлекательность, аттракцион
attractive	привлекательный
attract	привлекать
attributed	приписанный 
attribute	приписывать
at	в, у
auction	аукцион
audacity	отвага, нахальство
audible	слышный, слышимый
audience	публика
auditorium	зрительный зал
August	август
aunt	тетя
authentic	подлинный
authoritative	авторитетный
authorities	власти 
authority	власть, полномочие, управление
authorize	санкционировать
authors	авторы 
author	автор
autobiography	автобиография
autograph	автограф 
automatically	автоматически
automatic	автоматический
automobile	автомобиль
auto	автомобиль
autumn	осень
auxiliary	вспомогательный, дополнительный
available	доступный
avalanche	снежный обвал, лавина
avenge	(ото)мстить
avenue	проспект
average	средний
aversion	отвращение
ave	прощание
avoid	избегать, избежать
await	ждать
awakened	пробужденный 
awake	бодрствующий
aware	сознающий
away	прочь
awestruck	пораженный
awe	(благоговейный) страх
awfully	ужасно, очень (разг.), крайне
awful	ужасный
awhile	некоторое время
awkward	неуклюжий
awoke	будил
axis	ось
aye	утвердительный ответ, положительный ответ (не yes) 
ay	да 
a	неопределенный артикль
babble	бормотание, болтовня
baby	ребенок
bab	бэб 
backed	поддержанный 
background	фон, задний план
backs	задние части
backup	резервный
backwards	назад 
backward	назад, обратно, наоборот
back	спина, назад
bacon	бекон
bade	предлагал 
badger	барсук, травить
badge	знак, символ, эмблема
badly	сильно, плохо
bad	плохой
baffle	озадачивать, мешать
bagful	мешок
baggage	багаж
bags	сумки, багаж (от bag)
bag	сумка
bail	поручительство
bait	приманка
bakery	пекарня
bakery	пекарня
baker	пекарь, булочник
balanced	уравновешенный
balance	равновесие
balcony	балкон
bald	лысый, оголенный
ballast	балласт, опыт, убеждения
ballet	балет
balloons	воздушные шары 
balloon	воздушный шар
ball	мяч
balmy	душистый, нежный, целебный
bamboo	бамбук
bananas	бананы (от banana)
banana	банан
bandage	бинт, повязка, перевязывать, бинтовать
bands	ансамбли (от band)
bandy	перебрасываться, хоккей, клюшка
band	лента, оркестр, ансамбль (музыкальный)
banged	ударенный (!NEW!)
bang	ударять, хлопать (дверью и т.п.)
banisters	перила (лестницы)
bank	банк
banner	знамя
banquet	банкет
ban	запрещать
barbara	барбара 
barbed	колючий, ядовитый
barefooted	босой
barely	только, едва
bare	голый, бедный, простой
bargain	сделка
barge	баржа
bark	кора дерева
barley	ячмень
barnabas	барнабас 
barnacle	моллюск 
barn	амбар
baron	барон 
barrel	баррель
barren	бесплодный, неплодородный
barrier	барьер, преграда
barrow	носилки
bars	бруски(бары) 
barton	имение, поместье, усадьба (не estate) (!NEW!)
bar	бар
baseball	бейсбол
based	основанный 
basement	основание
base	основа
basically	в основном
basic	основной
basin	бассейн
basis	основа, основание
basket	корзина
bass	бас, басовый
batch	выпечка, партия, группа
bates	убавляет 
bathe	купаться
bathing	купание, купальный
bathroom	ванная комната
bath	ванна
battery	аккумулятор
battle	бой, сражение
bat	бить
bay	бухта, залив
beach	пляж
beacon	сигнальный огонь, маяк
beagle	гончая 
beaker	кубок, чаша (не rummer)
beak	клюв
beamed	сиял 
beaming	сияющий (от слова beam) 
beams	лучи 
beam	сиять, излучать (свет)
beans	фасоль
bean	боб
bearable	терпимый, сносный
beard	борода
bearer	носитель, податель, предъявитель
bearing	отношение(поведение)
bears	медведи 
bear	медведь, спекулянт
beastly	противный (разг.)  (от слова зверь!!!)
beasts	звери (!NEW!)
beast	зверь, животное
beaten	битый
beating	поражение
beat	ударить, бить
beautifully	красиво, прекрасно
beautiful	красивый
beauty	красота, косметический
beau	кавалер, поклонник
became	становился, стал (от become)
because	потому что
beck	кивок, приветствие
becomes	становится (от become)
become	становиться
becoming	подобающий, приличествующий, соответственный, идущий (к лицу) (не eligible, suitable)
bedding	спальные принадлежности (bedding)
bedroom	спальня
bedside	постель
beds	кровати 
bed	постель
beech	бук
beef	говядина
beehive	улей
been	быть (от be)
beer	пиво
bees	пчелы 
beetle	трамбовать, дробить камни
beetroot	красная свекла
bee	пчела
beforehand	заранее
before	перед, до того как
began	начинал, начал (от begin)
beggar	нищий
beginner	новичок (не newcomer)
beginning	начало
begins	начинается (от begin)
begin	начинать(ся)
begun	начатый 
beg	просить, умолять
behalf	защита 
behaved	вел себя 
behave	вести себя
behaviour	поведение
beheld	созерцал 
behind	позади
behold	созерцать 
beings	существа 
being	будучи (от be)
belfry	колокольня
belief	вера, доверие
believed	верил, полагал (от believe)
believes	верит 
believe	верить
believing	вера
bellamy	беллами 
bella	белла 
bellow	мычание, греметь, громыхать (не rattle)
belly	живот, аппетит
bell	звонок
belonged	принадлежащий (!NEW!)
belongings	вещи, пожитки
belong	принадлежать
beloved	любимый
below	ниже, внизу
belt	пояс, ремень
bench	скамейка
bending	изгиб
bend	гнуться, изгибаться
beneath	под, ниже, внизу
benefit	благо, польза
bennet	беннет 
bent	склонность, наклонность
Ben	бен 
berenice	беренис 
berries	ягоды (от berry)
berth	койка, спальное место
bertram	бертрам 
beset	окружать
besides	кроме, кроме того
beside	рядом, около
bestowed	подаренный 
best	наилучший
Beth	бет 
betrayed	преданный (от слова предательство) 
betray	предавать
better	лучше
Betty	бетти 
between	между
bet	держать пари, пари
beverley	беверлей 
bewail	оплакивать, скорбеть
beware	осторожно
bewildered	пораженный, изумленный
beyond	далеко, вдали, на расстоянии, вне, сверх
be	быть
Bible	библия
bicyclelist	велосипедист
bicycle	велосипед
bicycle	велосипед
bidding	понижение цены
bid	предложение 
bigger	больший 
big	большой
bikes	велосипеды 
bike	велосипед
billion	биллион, миллиард (амер.)
billy	билли 
bill	счет, законопроект
binary	набор из двух предметов 
binding	переплет
bind	связывать (не link)
bingo	лото 
bin	бункер (!NEW!)
biology	биология
birch	береза, розга
bird	птица
birthday	день рождения
birth	рождение
biscuit	сухое печенье
bishop	епископ, слон (шахм.)
bite	кусаться
biting	острый, резкий
bits	куски (!NEW!)
bitterly	горько, сильно
bitter	горький, мучительный
bit	кусочек, немного
blab	болтун, болтать (не от слова chat)
blackbird	черный дрозд
blackened	почерневший 
blacken	чернить, чернеть
black	черный
bladders	пузыри 
blades	лезвия 
blade	лезвие
blake	блак 
blame	считать виноватым, вина, упрек, порицание
blanket	одеяло
blank	пустой, чистый
blast	взрыв, взрывать, разрушать
blaze	пламя, пылать, гореть (не flame)
blazing	сверкание
bleach	белить (ткань)
bleeding	кровотечение 
blend	смешивать, смесь
blessed	благословлённый (!NEW!)
blessing	благословение
bless	благословлять
blew	дул (!NEW!)
blind	слепой
blinked	мигал 
blink	мерцание, отблеск, блеснуть, моргать
bliss	блаженство, счастье
blizzard	метель, пурга
blobs	капли (не drops) 
blob	капля, комочек (не drop)
blockade	блокада
blocked	блокированный 
blocks	кварталы (от block)
block	блок, квартал
block	блок, квартал
blonde	блондин
blond	белокурый
bloody	кровавый
blood	кровь
bloom	цветение
blossom	цветок (на деревьях, кустах), расцветать
blot	клякса, пятно, промокать
blouse	блуза
blown	сдутый 
blow	дуть
blue	синий
blunt	притуплять
blush	(по)краснеть; краска стыда, смущения
boarding	посадка (самолёта)
board	садиться на пароход, самолет; доска
boast	хвастовство, хвастать
boats	лодки (!NEW!)
boat	лодка, пароход
Bodies	органы(тела) 
bodily	лично, сам, собственной персоной (не myself)
body	тело
bog	трясина
boiled	вареный, кипяченый
boiler	котел
boil	кипятить, кипеть
boisterous	неистовый, шумный
boldly	смело 
bold	смелый (не dare)
bolt	молния
bomb	бомба, бомбить
bondage	рабство, зависимость (не slavery)
bones	кости (!NEW!)
bone	кость
bonfire	костер
bonnet	капор, дамская шляпа
bonus	премия
bookcase	книжный шкаф
booking	продажа билетов
booklet	брошюра, буклет
bookshelf	книжная полка
books	книги (от book)
book	книга, покупать (билет)
boost	повышение, повышать
booth	кабинка
boots	ботинки, сапоги (от boot)
booty	награбленное добро, добыча
boot	ботинок, сапог
border	граница
bore	скука
boring	скучный
borne	ограниченный, с узким кругозором, узколобый, закостенелый 
born	рожденный
borrowed	брал в долг, взятый в долг (от borrow)
borrow	брать в долг
bosom	грудь (не chest)
boss	начальник
bother	беспокойство, хлопоты; источник беспокойства
both	оба
bottles	бутылки (от bottle)
bottle	бутылка
bottom	дно, донышко; нижняя часть
bought	купил, купленный (от buy)
bough	ветвь, сук
boulevard	бульвар
boulevard	бульвар
bounce	отскакивать
boundary	граница
boundless	безграничный
bounds	граница, ограничение (от bound)
bound	непременный, обязательный
bout	черед, круг
bowed	поклонился 
bowl	кубок, чаша
bow	кланяться, сгибаться
boxes	ложи (от box)
boxing	бокс
box	ящик, коробка, ложа (театр.)
boy	мальчик, юноша
braces	подтяжки
brace	связывать, скреплять (не clamp)
bracket	скобка, подпорка, заключать в скобки
bradley	брадлей 
brain	мозг
brakes	тормоза (от brake)
brake	тормоз
branches	ветки (!NEW!)
branch	ветвь, отрасль
brandy	коньяк, бренди
brand	головня, клеймо, фабричная марка, сорт, клеймить
brass	установить
bravely	смело
bravery	храбрость, смелость
brave	храбрый, смелый
brawl	уличный скандал
breach	брешь, пробивать брешь
breadth	ширина, полотнище
bread	хлеб
breakfast	завтрак
break	ломать
breast	грудь
breathe	дышать
breathing	дыхание
breathless	запыхавшийся
breath	дыхание
bred	разводимый 
breeches	брюки, бриджи (не trousers)
breeder	производитель
breeding	разведение
breeds	породы 
breed	порода
breeze	легкий ветер
brewing	затевающий, надвигающийся (от brew)
brew	затевать, надвигаться
bricks	кубики (детские)
brick	кирпич
bride	невеста
bridge	мост
bridle	узда, повод, взнуздывать
briefcase	портфель
briefly	кратко, сжато
brief	короткий, сводка, резюме
brigade	бригада
brightly	ярко 
bright	ясный
brilliance	блеск, великолепие, яркость (не brightness)
brilliant	блестящий, брильянт
brim	край, поля (шляпы)
brings	приносит 
bring	приносить, приводить
brisk	живой, проворный
Britain	британия
British	британский
brittle	хрупкий, ломкий (не fragile)
broadcasting	радиовещание
broadcast	передача по радио
broadly	широко
broad	широкий
broken	разбитый, сломанный, нарушенный, ломаный (о языке)
broke	(с)ломал, сломанный (от break)
bronze	бронзовый
brooch	брошь
brood	высиживать (цыплят), выводок
brook	ручей
broom	метла, мести
brother	брат
brought	принес, принесенный (от bring)
brown	коричневый
brows	брови 
brow	бровь
bruises	ушибы 
bruise	ушибать, синяк, ушиб
brushed	чистил (не cleaned) 
brush	щетка, чистить щеткой
brutally	грубо, жестоко
brutal	грубый, жестокий
brute	зверь, скотина (не beast)
bubble	пузырь
bucket	ведро
buckwheat	гречиха
budge	шевелиться
buds	почка, расцветать (!NEW!)
bud	почка, бутон, давать почки, пускать ростки
buffalo	буйвол
buffer	буфер 
bugs	ошибки(дефекты) 
bug	клоп, насекомое, жук (амер.)
builder	строитель
building	здание
builds	строит 
build	строить
built	строил, построенный (от build)
bulb	луковица, электрическая лампочка
bulky	громоздкий
bulk	груз, величина
bullet	пуля
bully	запугивать (не scare)
bull	бык
bump	удар, толчок, шишка, ударять(ся), стукаться
bum	бездельник, бродяга
bunch	связка, пучок
bundle	узел, пакет
bungalow	(одноэтажная) дача, бунгало
bun	булочка
buoy	буй, бакен
burden	груз, бремя
bureau	бюро, контора
burglary	кража со взломом
burial	похороны
buried	спрятанный, похороненный (!NEW!)
burlap	холст, мешковина (не canvas)
burly	крепкий (!NEW!)
burn	гореть, жечь, сжигать
burst	заливаться, разражаться
bury	хоронить, прятать
bushes	кусты (!NEW!)
bush	куст
busily	деловито 
businessmen	бизнесмены (от businessman)
business	дело, бизнес, деловой
bustle	суетиться, суматоха, суета
busts	бюсты 
bust	бюст
busy	занятый
bus	автобус
bus	автобус
butcher	мясник
butler	дворецкий 
butter	масло
buttons	кнопки 
button	кнопка, пуговица
but	но
buyer	покупатель
buy	покупать, купить
buzzer	(фабричный) гудок
buzz	жужжать, гудеть, жужжание, гул
bye	пока (при прощании)
BYTES	байты 
byte	байт 
byword	поговорка, олицетворение (не dictum)
by	по, при, путем
cabbage	капуста
cabbage	капуста
cabinet	кабинет (не parlour)
cabin	каюта
cable	кабельный
cab	наемный экипаж, извозчик, такси
cache	тайник 
cadence	ритм, интонация
caesar	каесар 
cafe	кафе
cages	клетки 
cage	клетка, кабина
cakes	пироги (!NEW!)
cake	торт
calamity	стихийное бедствие, большое несчастье
calculated	расчетный 
calculate	рассчитывать, вычислять
caleb	калеб 
calendar	календарь
calf	слоненок, теленок, молодой кит
called	звонил, названный (от call)
calling	звонящий (от call)
call	звонить, называть (call)
calmly	тихо, спокойно (!NEW!)
calm	успокаивать
Cambridge	кембридж 
camera	фотоаппарат
came	пришел (от come)
campaign	компания, проводить кампанию
camp	лагерь
cancel	отменить, сократить
candidate	кандидат
candle	свеча
candling	миражирование
canes	тростники(трости) 
cane	трость, палка
canned	консервированный
cannon	пушка, орудие
cannot	не уметь (отрицательная форма глагола can)
canoe	челн, байдарка
canteen	столовая
canvas	холст, парус
canyon	каньон 
can	уметь, мочь
capable	способный
capacious	просторный, вместительный, объемистый
capacity	емкость, способность
cape	мыс
capitalist	капиталист, капиталистический
capital	столица
captain	капитан
captive	пленный
captivity	захват 
captured	захваченный 
capture	захват, поймать
cap	шапка
caravan	фургон
carbonate	карбонат 
carbon	углерод
cardboard	картон
cards	карточки (от card)
card	карточка
careers	профессии (от career)
career	профессия, карьера
carefully	осторожно, внимательно
careful	осторожный
careless	беззаботный
CAREs	заботится, переживает (от care)
care	заботиться, переживать
cargo	груз
caricature	карикатура
carla	карла 
carlos	карлос 
carpenter	плотник
carpet	ковер, устилать
carriage	вагон
carrier	носильщик, транспортное средство
carrot	морковь
carrying	перевозка
carry	нести, носить, возить
carter	возчик; ломовой извозчик ((!NEW!))
carton	коробка
cartoon	мультфильм
cart	телега, повозка
Carved	вырезанный (из дерева, из камня) ((!NEW!))
carve	вырезать, отрезать
car	машина
car	машина
case	случай, состояние
cash	деньги
casks	бочки 
castle	замок (не железный, а каменный)
cast	бросать, ронять, менять
casual	случайный (не random)
catching	ловля 
catch	уловить, понять, получить нагоняй
cathedral	собор
Catherine	кэтрин 
cats	коты 
cattle	(рогатый) скот
cat	кошка
caught	ловил ((!NEW!))
cauldron	котел 
cause	дело, причина
causing	порождение
caution	осторожность
cautiously	осторожно ((!NEW!))
cautious	осторожный
cavern	пещера 
cave	пещера
cavity	впадина, полость
ceased	прекратил 
cease	прекращать, останавливать
ceiling	потолок
celebrated	праздновал (от celebrate)
celebrate	праздновать
celebration	празднование
celebrity	известность, знаменитость
cellar	подвал, винный погреб
cells	ячейки 
cell	камера, ячейка
cement	цемент, основа
cemetery	кладбище
center	центр
central	центральный
centre	центр
centuries	столетия 
century	столетие, век
cent	цент
cereals	хлебные злаки, зерновые
ceremony	церемония
certainly	конечно
certainty	уверенность
certain	определенный, некоторый, некий
certificate	справка, аттестат
cessation	прекращение (не interrupt)
chain	цепь
chairman	председатель
chair	стул
Chaise	фаэтон 
chalked	рисовавший мелом 
chalk	мел
challenge	вызывать, вызов
chambers	палаты
chamber	палата
champagne	шампанское
championship	чемпионат, звание чемпиона
champion	чемпион
chances	возможности 
chance	случай, шанс
changed	поменял, изменил (от change)
changes	меняется (от change)
change	мелкие деньги, сдача, менять, пересаживаться
changing	изменение(замена) 
channel	канал
chapters	главы 
chapter	глава (книги)
chap	парень (разг.), малый
characteristic	особенность
character	характер
charges	издержки, расходы (от charge)
charge	плата, стоимость, взимать плату
charity	милосердие
charles	чарльз 
charley	чарли 
charlotte	шарлотта 
charming	очаровательный, прелестный
charms	обаяния 
charm	очарование
char	случайная работа 
chase	охотиться, преследовать, погоня, охота
chasing	уклоняющийся (от chase)
chatterbox	болтунья
chatter	болтать, болтовня
chat	беседа, болтовня (не blab)
chauffeur	шофер
cheaply	дешево, легко
cheap	дешевый
cheat	обманывать, надувать, обманщик, плут
checking	проверка 
check	проверять, регистрировать
cheeky	развязный
cheek	щека
cheerfully	бодро ((!NEW!))
cheerful	жизнерадостный, веселый
cheers	да здравствует (приветственное восклицание)
cheer	настроение
cheese	сыр
chemical	химический
chemistry	химия
chemist	химик, аптекарь
cheque	банковский чек
cherish	лелеять
cherries	вишни (от cherry)
cherry	вишня
chess	шахматы
chestnut	каштан
chest	грудь
Chevy	охота, погоня, гнаться (не chase)
chew	жевать
chicken	цыпленок, кура
chiefly	главным образом
chief	шеф, начальник
childhood	детство
childish	детский, ребяческий
children	дети
child	ребенок
chilly	холодный, сухой, чопорный
chill	холод, простуда
chimney	труба
China	фарфор
chin	подбородок
chip	обломок, осколок
chisel	резец, ваять, высекать
chivalrous	рыцарский
chocolate	шоколад
choice	выбор ( не choose)
choked	забитый 
choose	выбирать
chorus	хор
chosen	выбранный (от choose)
chose	выбирал, выбрал (от choose)
Christian	христианский, христианин
Christmas	рождество
Chris	крис 
chronicle	летопись, хроника, отмечать
chuckled	Хихикал 
churchill	черчилл 
churchyard	кладбище
church	церковь
church	церковь
cigarettes	сигареты (от cigarette)
cigarette	сигарета
cigar	сигара
cinema	кино
circle	амфитеатр, круг
circuit	кругооборот, окружность
circular	круглый, реклама
circulate	повторяться, передаваться
circulation	кровообращение, тираж
circumference	окружность
circumstances	обстоятельства, условия
circumstance	обстоятельство, условие
circumstantial	обстоятельный, случайный
circus	цирк, арена
citizens	граждане 
citizen	гражданин
city	город
civilization	цивилизация
civil	гражданский
claimed	требуемый 
claims	требования 
claim	требовать
clamour	шум, крики
clamp	складывать, скреплять (не brace)
clank	бряцать, хлопать в ладоши
clap	хлопать, аплодировать; удар, хлопок
clash	столкновение, конфликт
Clasped	сжатый (не от слов squeeze, tight) 
clasp	прижимать (к груди), обнимать, сжимать (в руке)
classes	занятия, уроки  (не lessons)
classic	классический
classroom	класс
class	класс (не grade)
clatter	стук, звон; стучать, греметь
clause	предложение, статья
claw	коготь, клешня
clay	глина, земля
cleaned	чистил, (по)чищенный (от clean)
cleaning	чистка
cleanliness	чистоплотность
cleanup	уборка 
clean	чистить, чистый
cleared	рассчитался (от clear)
clearing	clearing 
clearly	ясно (не obvious)
clear	ясный, светлый, очищать, расплатиться
clenched	сжатый
clench	сжимать (кулаки, зубы)
cleopatra	клеопатра 
clergyman	священник
clerk	чиновник
clever	умный
click	щелкать
clients	клиенты 
client	клиент
cliffs	утесы 
cliff	утес, скала
climate	климат
climax	кульминационный пункт
climb	подниматься, влезать
cling	цепляться, (при)льнуть
clink	звенеть, звон
clip	стричь, обрезать, зажимать (не trim)
cloak	плащ, камера хранения (багажа)
clock	часы (не watch)
closed	закрыл, закрытый (от close)
closely	близко, тесно
closet	чулан
close	закрывать(ся)
closing	заключительный
closure	закрытие
clothes	одежда
clothe	одевать
clothing	одежда, обмундирование
cloth	ткань
cloud	облако
club	клуб
clue	ключ (к разгадке), улика
clumsy	неуклюжий
clung	цеплялся 
cluster	гроздь; скопляться, тесниться
clutch	захват (не snatch)
coach	тренировать, инструктор
coach	тренировать, инструктор
coal	уголь
coarse	грубый
coast	побережье
coats	пальто 
coat	пальто
coax	уговаривать, задабривать
cobbler	сапожник
cobweb	паутина
cocktail	коктейль
cock	петух, задирать
cocoa	какао
cocoon	кокон
code	код
coffee	кофе
cognomen	прозвище, фамилия (не nickname)
coil	виток, катушка
coincidence	совпадение
coins	монеты (от coin)
coin	монета
cold	холод, холодный
colin	колин 
collapse	крушение, крах, рушиться, потерпеть крах
collar	воротник
collations	сопоставления 
collation	сопоставление 
colleague	коллега
collected	коллекционировал (от collect)
Collections	собирание, выемка (от collection)
collection	коллекция
collector	сборщик, коллекционер
collect	коллекционировать
college	колледж
collision	столкновение
colonel	полковник
colonial	колониальный
colonize	заселять, колонизировать
colony	колония
colon	двоеточие
colored	цветной 
colorful	красочный
color	цвет 
coloured	цветной
colourful	красочный
Colours	цвета (от colour)
colour	цвет
columns	колонки 
column	графа, отдел
col	седло 
combat	бой, борьба (не battle)
combination	комбинация, объединение
combined	объединенный 
combine	объединять (не connect)
comb	гребенка, расчесывать, расчесать
comedy	комедия
comely	хорошенький, миловидный (не pretty, lovely)
comer	приходящий
come	приходить, приезжать
comfortable	удобный
comfort	удобство, утешение, утешать
comics	комиксы
comic	кинокомедия, комический
coming	приход, приходящий (от come)
commander	командир, начальник
commands	команды 
command	приказ, управлять, приказывать
comma	запятая
commend	хвалить
comment	комментарий, комментировать
commerce	торговля, коммерция
commercial	торговый
commission	комиссионные
committed	совершенный(переданный) 
committee	комитет, комиссия
commit	совершать (преступление)
commonly	обыкновенно, дешево, плохо
commonplace	банальность, общее место; банальный
common	общий
commotion	смятение, волнение
communicated	сообщенный 
communicate	сообщать, общаться
communication	сообщение, связь, общение
community	община
compact	компактный
companion	товарищ
company	компания, общество (company)
comparable	сравнимый
comparatively	сравнительно 
comparative	сравнительный, относительный
compared	сравнил (от compare)
compare	сравнивать
comparison	сравнение
compartment	купе
compassion	жалость, сострадание ((!NEW!))
compass	объем, диапазон; компас; циркуль
compatibility	совместимость ((!NEW!))
compelled	вынужденный 
compete	состязаться, конкурировать
competition	соревнование
compile	составлять
complaints	жалобы (от complaint)
complaint	жалоба
complain	жаловаться
completed	законченный 
completely	совершенно, полностью
complete	полный, законченный
completion	завершение, окончание
complexion	цвет лица
complex	сложный, составной, комплексный
complicated	сложный
complication	сложность
compliments	комплименты (от compliment)
compliment	комплимент
comply	уступать, соглашаться
component	компонент
composed	спокойный
compose	сочинять, составлять
composite	составной, сложный
composition	сочинение, композиция
composure	спокойствие, самообладание
compound	составной
comprehend	постигать 
comprehensive	исчерпывающий, обширный
compress	компресс
compromise	компромисс
computer	компьютер
concealed	скрытый 
conceal	скрывать, утаивать
concede	уступать, допускать
conceited	самодовольный, тщеславный
conceit	самомнение
conceived	задуманный 
conceive	постигать, понимать
concentrate	сосредотачиваться
concentration	концентрация, сосредоточенность
concept	концепция, понятие, идея
concerned	заинтересованный, озабоченный, огорченный
concerning	относительно (не relatively)
concern	забота
concert	концерт
concession	концессия
concluded	завершенный, законченный (не completed) ((!NEW!))
conclude	завершать, заключать
conclusions	заключения 
conclusion	заключение
concrete	бетон, сгущать, конкретный
concussion	сотрясение (мозга)
condescending	снисходительный
condition	условие
conducted	проводимый 
conductor	кондуктор
conduct	вести, руководитель, проводить
cone	конус, шишка (еловая)
conference	конференция, съезд
confer	обсуждать, совещаться; вести переговоры с
confessed	признанный 
confession	признание, исповедь
confess	признавать
confidence	доверие
confidential	конфиденциальный, доверчивый
confident	уверенный
confide	доверять, полагаться, признаваться
configuration	конфигурация 
confined	ограниченный(заключенный) 
confinement	заключение 
confirmed	подтвержденный 
confirm	подтверждать, утверждать
conflict	конфликт, противоречить
conform	соответствовать, подчиняться
confront	стоять против
confused	запутанный, смущённый ((!NEW!))
confuse	смущать, приводить в замешательство
confusion	смущение
congratulated	поздравил (от congratulate)
congratulate	поздравлять
congratulations	поздравления (от congratulation)
conjecture	догадка, предположение, предполагать
conjure	показывать фокусы
connecting	соединение
connections	связи 
connection	соединение
connect	соединять
conquered	побежденный 
conquer	завоевывать, завоевать
conquest	завоевание, покорение
conscience	совесть, сознание
conscientious	добросовестный
consciousness	сознание, сознательность
conscious	сознающий, ощущающий
consented	соглашался 
consent	разрешение
consequences	последствия 
consequence	следствие, вывод, значение
consequently	следовательно, в результате
conservative	консервативный, консерватор
considerable	значительный
considerably	значительно (не tremendously)
considerate	внимательный (к другим), чуткий
consideration	рассмотрение, соображение
considering	рассмотрение
consider	считать
consisted	состоял 
consistent	совместимый, согласующийся (не compatible)
consists	состоит (от consist)
consist	состоять
consolation	утешение
console	утешать
conspicuous	заметный, выдающийся
constantly	постоянно
constant	постоянный
constellation	созвездие
constitute	назначать, учреждать
constitution	конституция
constraints	ограничение 
constraint	ограничение 
construction	строительство
construct	строить,создавать
consulate	консульство
consultation	консультация, совещание
consult	советоваться
consume	потреблять
consumption	потребление, расход
contact	устанавливать связь
containing	содержащий 
contains	содержит 
contain	содержать, сдерживать
contemporary	современный
contempt	презрение (не aversion)
contend	бороться, соперничать
contented	удовлетворенный (не satisfied) 
contents	содержание, содержимое, оглавление
content	содержание
contest	спор, соревнование, спорить
context	контекст, ситуация
continental	континентальный
continent	континент
continually	непрерывно
continual	беспрестанный
continuation	продолжение
continued	продолжал (от continue)
continue	продолжать(ся)
continuous	непрерывный
contract	договор, контракт
contradict	опровергать, противоречить
contrary	противоположный (не opposite)
contrast	противоположность, контраст
contribute	делать вклад, способствовать
contribution	вклад
contributor	сотрудник
contrivance	изобретение, приспособление
contrived	изобретенный 
control	контроль, управление
convalesce	выздоравливать
conveniences	удобства (от convenience)
convenience	удобство
convenient	подходящий, удобный
conventional	обычный, обусловленный
convention	собрание, съезд
conversation	разговор, беседа
conversion	превращение, обращение
converted	преобразованный(конвертированный) 
convert	превращать, обращать, конвертировать
conveyed	переданный 
convey	перевозить, передавать, сообщать
conviction	осуждение, убеждение, убежденность
convict	признать виновным, осудить
convinced	убежденный
convince	убеждать
convincing	убедительный
con	подставить 
cooked	готовил (от cook)
cook	готовить, повар
cooler	холоднее (от cool)
cooling	охлаждение
coolly	прохладно 
coolness	прохлада, хладнокровие
cool	прохладный, холодный
cooperative	кооперативный
cope	справиться, совладать
copies	копии 
copper	медь
copyright	авторское право
copy	копия, копировать
coral	коралл 
cordial	сердечный
cord	шнур
core	сущность, суть
cork	поплавок
corners	углы 
corner	угол
corn	кукуруза
correction	исправление
correctly	правильно, верно
correct	исправлять, правильный
correlation	корреляция 
correspondence	корреспонденция, переписка
corresponding	соответственный, соответствующий
corridor	коридор
corruption	продажность
corrupt	испорченный, развращенный, продажный
cosmetic	косметический
costume	костюм
cost	стоить, стоил
cosy	уютный
cottage	коттедж
cotton	хлопок, хлопчатобумажный
couch	кушетка
cough	кашель
could	мог, могли (бы)
councilman	член совета 
council	совет, совещание (не counsel)
counsel	обсуждение, совет, решение, адвокат
countenance	самообладание(лицо) 
counteract	противодействовать (не contradict)
counter	прилавок, противостоять, противиться
countless	бесчисленный
countries	страны (от country)
countryside	сельская местность
country	страна
county	графство
count	считать, принимать во внимание
couple	пара
courageous	смелый, отважный
courage	мужество, смелость
course	курс, блюдо
courtyard	двор
court	корт, двор
cousins	кузены ((!NEW!))
cousin	двоюродный брат
covering	покрытие 
cover	покрывало, крышка
cove	сооружать
cowardly	трусливый, малодушный
coward	трус
cow	корова
co	компания 
crab	краб
cracker	печенье, хлопушка
crackle	хрустеть, потрескивать
crack	попытка, проба, трещина
cradle	колыбель, убаюкивать
craftsman	ремесленник
craft	искусство, судно
cram	запихивать, пичкать, учить наспех, натаскивать (к экзаменам)  ( не poke)
crane	журавль, подъемный кран
cranny	скважина, трещина
crashed	потерпел крах 
crash	потерпеть крах, потерпеть крушение
crawford	кравфорд 
crawled	ползал (не от слова creep) 
crawl	ползать (не creep)
crazy	безумный
creak	скрип, скрипеть
cream	сливки, крем
created	созданный 
create	создавать
creating	создание
creation	создание (похоже на creature)
creator	творец, создатель, автор
creatures	существа 
creature	творение, создание
credentials	верительные грамоты, рекомендация
credit	кредит
creeper	вьющееся растение
creeping	ползающий 
creep	ползать, выползать
crept	ползал ((!NEW!))
crescent	полумесяц
crest	гребешок, хохолок, гребень (волны, горы)
crevice	трещина, расщелина
crew	судовая команда, экипаж
cricket	крикет (спорт.)
cries	крики 
crime	преступление, преступность
criminal	преступник, уголовный
crimson	алый, малиновый (не scarlet)
cringe	раболепствовать
cripple	калечить, уродовать (не destroy, disable)
crisis	кризис, перелом (в ходе болезни)
crisp	хрустящий картофель
critical	критический
criticism	критика
criticize	критиковать
crocodile	крокодил
crooked	кривой
crook	крюк, крючок, поворот
crop	урожай
crossing	переход, пересечение
cross	пересекать
crouched	присел 
crouch	притаиться
crowded	многолюдный
crowd	толпа, толпиться
crown	корона
crow	ворона
crude	сырой, необработанный
cruelty	жестокость
cruel	жестокий, беспощадный
cruise	морское путешествие
crumble	крошить(ся)
crumb	крошка
crushed	сокрушенный 
crust	корка, кора
crying	кричащий
crystal	хрусталь
cry	кричать, восклицать
cubic	кубический
cub	детеныш (зверя)
cuckoo	кукушка
cucumbers	огурцы (от cucumber)
cucumber	огурец
cuff	наручники, лёгкий удар
culprit	обвиняемый, преступник (не accused)
cultivated	выращенный 
cultivate	обрабатывать
cultivation	культивирование 
cunning	хитрость, хитрый, коварный
cupboard	буфет
cupboard	буфет
Cups	чашки (от cup)
cup	чашка
cup	чашка
curb	сдерживать
curdle	свертываться (о молоке)
cure	лекарство, лечить
curiosity	любопытство, редкая вещь
curiously	странно (не strangely) ((!NEW!))
curious	любознательный
curled	вился 
curls	завитки 
curl	виться, завивать(ся); локон, завиток
currant	коринка, смородина
currently	в настоящее время 
current	течение, ток
curse	проклятие
cursor	курсор 
curtains	занавески ((!NEW!))
curtain	занавеска, занавес
curt	краткий, сжатый, грубый
curvature	искривление 
curved	изогнутый 
curve	изгиб, гнуть
cushion	подушка
customary	обычный
customer	клиент
custom	обычай
cute	изящный, прелестный
cutting	сокращение, урезание
cut	разрез, фасон (стрижки волос)
cycle	цикл, период
cyclist	велосипедист
czar	царь
dad	папа, отец
dagger	кинжал
daily	ежедневно
dainty	лакомство, деликатес
dairy	молочный магазин
daisy	маргаритка
dalton	далтон 
damage	повреждать, причинять ущерб
dame	дама, пожилая женщина (не lady)
damp	сырой, влажный
dam	дамба, плотина
danced	танцевал (от dance)
dance	танцевать
dancing	танцы
dandy	нарядный, великолепный
dangerous	опасный
dangers	опасности 
danger	опасность
dangle	качаться, подвешивать
Dan	дэн 
darcy	дарси 
dared	осмелившийся ((!NEW!))
dare	сметь, отважиться
daring	смелость, отвага; смелый, отважный
darkened	затемненный
darker	более темный 
darkness	темнота, мрак
dark	темный, печальный
darling	любимый, дорогой
darn	штопать
darted	брошенный (не dashed) 
darwin	дарвин 
dashed	брошенный ((!NEW!))
dash	оттолкнуть, отбросить
databases	базы данных 
database	база данных 
data	данные, факты
dates	даты (от date)
date	дата
daughters	дочери (от daughter)
daughter	дочь
David	дэвид 
dawn	рассвет, светать
daybreak	рассвет
daylight	дневной свет
days	дни (от day)
daytime	дневное время
day	день
dazed	ошеломленный
deadlock	тупик, безвыходное положение
deadly	смертельно
dead	мертвый
deaf	глухой
dealing	раздачаv
deal	значительное количество
dean	декан
dearest	дорогой (не darling) 
dear	дорогой
death	смерть
debate	дебаты, спор, полемика
debris	обломки, развалины
debts	долги (от debt)
debt	долг
decay	гниение, разложение
deceived	обманутый ((!NEW!))
deceive	обманывать
December	декабрь
decency	приличие, благопристойность
decent	приличный, скромный
deception	обман, хитрость
deceptive	обманчивый
decidedly	определённо, точно, бесспорно (не doubtless) ((!NEW!))
decided	решил (от decide)
decide	решать
decimal	десятичный, десятичная дробь
decipher	расшифровывать
decision	решение
decisive	решающий
deck	палуба
declaration	декларация
declared	объявленный 
declare	декларировать
declined	отклоненный
decline	опускаться, уменьшаться, убывать
decorate	украшать
decoy	западня, приманка; заманивать в ловушку
decrease	уменьшать, уменьшить
decree	декрет, указ; издавать декрет; постановлять
decrepit	ветхий, дряхлый
dedicate	посвящать, посвятить
deduction	вычитание, вычет, удержание, вывод, заключение
deed	подвиг, дело
deeper	глубже 
deeply	глубоко
deep	глубокий
deer	олень, лань
default	неплатеж, невыполнение обязательств 
defeated	побеждённый ((!NEW!))
defeat	поражение
defective	неисправный, недостаточный, неполноценный, дефективный
defect	недостаток, недочет
defence	оборона, защита
defender	защитник, чемпион (не champion)
defend	защищать, оборонять
defense	оборона ((!NEW!))
defensive	оборонительный, оборона
defiance	неповиновение, пренебрежение
defiant	вызывающий, дерзкий
deficiency	недостаток, дефицит
defined	определенный 
define	определять, устанавливать
definitely	определенно 
definite	определенный, точный
definition	определение
defy	действовать наперекор
degrade	понижать, разжаловать
degree	степень, звание
deity	божество
dejected	удрученный, угнетенный
delayed	отложен (от delay)
delay	отсрочка
delete	удалить 
deliberately	сознательно, обдуманно ((!NEW!))
deliberate	умышленный, обдуманный
delicacy	деликатность, тонкость, нежность (красок); хрупкость, болезненность
delicate	изящный
delicious	восхитительный, прелестный, вкусный
delighted	восхищался (от delight)
delightful	восхитительный (не marvellous)
delight	восхищение, восхищаться
delirium	бред
deliverance	освобождение, избавление
delivered	доставил (от deliver)
delivery	доставка
deliver	доставлять, передавать
deluge	наводнение, ливень
delusion	заблуждение
delve	впадина, рытвина
demanded	требовал (от demand)
demand	требовать
demolition	уничтожение
demonstrate	демонстрировать
demonstration	демонстрация
dene	долина, дюны
denial	отрицание, опровержение
denied	отклоненный 
denote	означать, обозначать
dense	густой, плотный (не bushy)
dentist	зубной врач
dentist	зубной врач
deny	отрицать, отвергать
den	берлога, притон
departed	отбыл 
departments	отделы, отделения (от department)
department	отдел
departure	отъезд, отправление
depart	отбывать, уезжать
dependant	иждивенец
depended	зависел 
dependent	зависимый, зависящий
depend	зависеть
deplore	сожалеть
deployment	развертывание
deploy	развертывать
deposit	взнос, вклад, залог, сдавать на хранение
depression	уныние, депрессия (эконом.)
deprive	лишать, отбирать
depths	глубины 
depth	глубина
deputy	депутат, делегат
derisive	насмешливый, иронический (не ironical)
derived	полученный 
descendant	потомок
descended	спускался 
descend	спускаться
descent	спуск, склон, десант, происхождение
describe	описывать
description	описание
deserted	брошенный, пустынный
deserter	дезертир
deserts	заслуги
desert	пустыня
deserved	заслуженный ((!NEW!))
deserves	заслуживает 
deserve	заслуживать
designed	предназначенный, намеренный
designer	конструктор
designs	проекты 
design	проектировать, спроектировать
desirable	желательный
desired	Желательный 
desire	желание
desk	письменный стол
desolate	покинутый, заброшенный
despair	отчаяние
desperately	отчаянно ((!NEW!))
desperate	отчаянный, безнадежный
despise	презирать
despite	несмотря на
dessert	десерт
destination	место назначения
destitute	сильно нуждающийся
destroyed	разрушенный 
destroyer	эскадренный миноносец
destroy	разрушать, уничтожать
destruction	разрушение
des	дес 
detached	отдельный
detachment	отряд
detach	отделять, посылать (воен.)
detailed	детальный, подробный
detail	деталь
detain	задерживать, удерживать
detected	обнаруженный 
detection	открытие, обнаружение
detectives	детективы 
detective	детектив(ный)
detect	открывать, обнаруживать
detention	задержание
determination	решимость, определение
determined	решительный
determine	определять, устанавливать, разрешать
detest	питать отвращение, ненавидеть
detrimental	приносящий ущерб (не destructive)
developed	развил (от develop)
developer	развивающийся (о человеке) ((!NEW!))
development	развитие
develop	развивать
device	прибор, схема, проект, прием, устройство
devil	дьявол, сатана
devoted	преданный
devote	посвящать
devotion	преданность
devour	пожирать
dew	роса
dexterity	проворство, ловкость
diagram	диаграмма, схема
dialect	диалект 
dialogue	диалог
dial	набирать номер
diameter	диаметр
diamond	алмаз, бриллиант
diana	диана 
diary	дневник
dick	дик 
dictionary	словарь
dictum	изречение, поговорка (не byword)
did	делал, действовал (от do)
died	умер, умерший (от die)
diet	диета
die	штамповать, чеканить
differences	различия 
difference	разница, различие
differently	по-другому
different	другой, отличный от
differs	отличается 
differ	различать
difficulty	препятствие, затруднение
difficult	трудный
digestion	пищеварение
digest	переваривать, усваивать, краткое изложение
digging	рытье
dignified	достойный
dignity	достоинство
dig	копать
diligence	прилежание
dime	дайм (10 центов)
dimly	смутно (не vague) ((!NEW!))
dim	тусклый, неясный, слабый (о зрении), туманный, смутный
dine	обедать
dining	обеденный
dinner	обед
din	шум, долбить
diploma	диплом, свидетельство
dipper	черпак, ковш
dip	погружать
directed	направленный 
directions	руководства(направления) 
direction	направление
directly	прямо, немедленно
directory	справочник
director	режиссер
direct	прямой, руководить
dirty	грязный
dirt	грязь
disabled	искалеченный, выведенный из строя
disable	делать непригодным (не destroy)
disadvantage	неудобство
disagreeable	неприятный
disappearance	исчезновение ((!NEW!))
disappeared	изчезнувший ((!NEW!))
disappearing	исчезновение
disappear	исчезать, исчезнуть
disappointed	разочарованный (от disappoint)
disappointing	печальный, неутешительный
disappointment	разочарование
disappoint	разочаровывать
disapproval	неодобрение
disarmament	разоружение
disarm	обезоруживать, разоружать(ся)
disaster	бедствие, несчастье
disastrous	бедственный
disbelief	недоверие
discern	различать, видеть
discharge	разряжать
discipline	дисциплина, обучение
disconnected	разъединенный
discontented	недовольный (не disagreeable)
discontent	недовольство (не unpleasure)
discourage	обескураживать
discovered	обнаруженный ((!NEW!))
discovery	открытие
discover	открывать, обнаруживать
discreet	осторожный, сдержанный
discretion	свобода действий; свободный выбор
discussed	обсуждал (от discuss)
discussing	обсуждающий, обсуждение (от discuss)
discussion	беседа
discuss	обсуждать
disc	диск
disdain	презирать, пренебрегать; презрение, пренебрежение (не neglect)
disease	болезнь
disgraceful	позорный
disgrace	позор, немилость
disguised	замаскированный ((!NEW!))
disguises	маскировки 
disguise	переодеваться, маскироваться, скрывать; маскировка
disgust	отвращение, вызывать отвращение
dishevelled	растрепанный, взъерошенный
dishonest	нечестный
dish	блюдо
disk	диск 
dislike	нелюбовь, неприязнь; не любить
dismal	мрачный, унылый (не gloomy, dreary)
dismay	ужас
dismissed	уволенный ((!NEW!))
dismiss	увольнять
dismount	спешиваться
disorder	беспорядок
disperse	рассеиваться
displayed	показанный 
display	показ, выставка
displeased	недовольный
displeasure	неудовольствие, недовольство, досада
disposal	вручение, право распоряжаться
disposed	склонный, расположенный, имеющийся под рукой (не inclined) ((!NEW!))
dispose	располагать
disposition	характер
dispute	диспут, полемика, обсуждать
disregard	пренебрегать, пренебрежение
dissolved	распущенный 
dissolve	растворять
distance	расстояние
distant	дальний, далекий
distinction	различие
distinctly	отчетливо
distinct	отдельный (не separate, detached)
distinguished	выдающийся, почетный
distinguish	отличать, различать, разделять
distracted	отвлеченный 
distract	отвлекать
distressed	обеспокоенный 
distress	горе, нужда; огорчать, расстраивать
distribute	распределять, распространять
distribution	распределение
district	район
distrust	недоверие, не доверять
disturbance	нарушение
disturbed	взбудораженный
disturb	нарушать, беспокоить
ditch	канава
ditty	песенка
dived	нырнул 
diverse	разный, различный (не various)
diver	водолаз
dive	нырять
divided	разделенный 
divide	делить, отделять
divine	божественный
diving	ныряние
division	деление
dizzy	головокружительный
dock	док, пристань
doctor	доктор, врач
doctor	доктор, врач
doctrine	доктрина 
documentation	документация 
document	документ
dodge	уловка, хитрость (не trick)
doer	исполнитель
does	делать, действовать, вспомогательный глагол (от do)
dog	собака
doing	делающий (от do)
dollars	доллары (от dollar)
dollar	доллар
dolls	куклы 
doll	кукла
domain	область 
domesticated	одомашненный 
domestic	домашний, внутренний
dome	купол
dominion	владычество, владение, доминион
donation	денежное пожертвование
done	сделанный (от do)
donkey	осел
doom	обрекать
doorway	дверной проем ((!NEW!))
door	дверь
dormitory	спальня
dorothy	дороти 
dose	доза, дозировать
dos	дос 
dots	точки 
dot	точка
double	двойной, на двоих
doubloons	дублоны 
doubly	вдвое
doubted	подвергнутый сомнению 
doubtful	сомневающийся (полон сомнений)
doubtless	несомненно
doubts	сомнения 
doubt	сомнение, сомневаться
dough	тесто
dove	голубь
downstairs	вниз, внизу, на нижнем этаже
downward	вниз, книзу
downy	пушистый
down	внизу, вниз
dozen	дюжина
doze	дремать
do	делать, действовать, вспомогательный глагол
draft	чертеж, проект
dragged	тянул 
dragon	дракон ((!NEW!))
drag	тащить
drain	вытекание
dramatic	драматический
drank	(вы)пил (от drink)
draught	сквозняк, набросок, черновик
drawers	кальсоны
drawer	чертежник
drawing	протаскивание, вытягивание, рисование, чертеж
drawn	нарисованный (от draw)
draw	рисовать
dreadfully	ужасно 
dreadful	ужасный (не terrible, horrible)
dread	страшиться, страх
dreams	мечты ((!NEW!))
dreamt	мечтал (от dream)
dream	мечтать, видеть сны
dreary	мрачный, унылый, скучный (не gloomy)
dressed	одетый
dressing	приправа
dressmaker	портниха
dress	платье, одеваться
drew	рисовал (от draw)
dried	сушеный
drift	сносить, плыть по течению
drill	дрель, тренировать
drinks	напитки (от drink)
drink	напиток, пить
drip	капать
driver	водитель, шофер
driveway	проезд ((!NEW!))
drive	водить машину, ехать на машине
driving	езда, вождение, движущий
drooping	свисающий
droop	поникать
dropped	потерянный, пролитый (не spoiled) ((!NEW!))
dropping	сбрасывающий
drops	снижения(капли) 
drop	капля, падать, ронять
drove	водил машину, ехал на машине (от drive)
drown	тонуть, топить(ся), заглушать
drowsy	сонный, дремлющий (не asleep, sleepy)
drugstore	аптека
drugstore	аптека
drug	лекарство, наркотик
drum	барабан
drunk	выпитый, пьяный (от drink)
dry	сухой
Dr	доктор 
dubious	сомнительный
duchess	герцогиня
ducked	увернулся 
ducks	утки 
duck	утка
dudley	дадли 
dues	сборы, взносы
due	должный, обязанный
dug	сиська, вымя ((!NEW!))
duke	герцог
dull	скучный
duly	должным образом
dumb	немой, бессловесный, бестолковый (амер.)
dummy	манекен, макет
dump	разгружать
dungeon	темница 
duplicate	дубликат, копия
durable	прочный
duration	продолжительность
during	во время
dusk	сумеречный, неясный, сумерки
duster	тряпка, щетка
dusty	пыльный
dust	пыль, вытирать пыль
duty	долг, обязанность, пошлина
dwarf	карлик, гном (миф.) (не gnome)
dwelling	жилье
dwell	жить
dwight	дуайт 
dyed	крашенный (от dye)
dye	красить, краска
dying	погибающий
dysentery	дизентерия
each	каждый
eagerly	охотно (не willing)
eagerness	пыл, рвение, желание
eager	нетерпеливый
eagle	орел
earlier	ранее 
earliest	самый ранний 
early	рано
earl	граф ((!NEW!))
earnestly	искренне (не sincerely) 
earnestness	серьезность (не seriousness) 
earnest	серьезный
earn	зарабатывать
earthquake	землетрясение
earth	земля
ear	ухо
easel	мольберт
ease	покой, непринужденность
easier	более легкий 
easily	легко
eastern	восточный
Easter	пасха
east	восток, восточный
easy	легкий, простой
eaten	eat (3 форма) 
eater	едок
eating	прием пищи, еда (
eat	есть (принимать пищу)
ebb	отлив, убывать
echo	эхо, отголосок
economical	бережливый, экономный
edge	край, точить
edible	съедобный
Edinburgh	Эдинбург 
edition	издание
editorial	редакционный, передовая статья (амер.)
editor	редактор
edit	редактировать
edmund	Эдмунд 
educated	образованный
educational	образовательный, воспитательный
education	образование
edward	Эдвард 
eerie	Жуткий
effected	произведенный (не produced)
effective	действующий, успешный
effects	Эффекты 
effectually	целесообразно 
effect	действие, влияние
efficiency	эффективность
efficient	эффективный
effort	усилие, напряжение
eggs	яйца (от egg)
egg	яйцо
Egypt	египет 
eighteen	восемнадцать
eighth	восьмой
eighty	восемьдесят
eight	восемь
either	или
elaborate	тщательно разработанный, подробный
elapse	проходить (о времени)
elastic	эластичный, упругий, резинка
elated	окрыленный
elbows	локти 
elbow	локоть
elderly	пожилой
elder	старший
eldest	(самый) старший
election	избрание, выборы
electricity	электричество
electric	электрический
electronic	электронный
elect	выбирать **e**
elegant	изящный
elementary	элементарный
elements	Элементы 
element	элемент, стихия
elephant	слон
elevated	поднятый 
elevate	поднимать, возвышать
elevation	возвышение 
elevator	лифт
eleven	одиннадцать
elf	Эльф 
eligible	подходящий (не suitable)
eliminate	исключать, уничтожать, ликвидировать
elinor	Элеонор 
elizabeth	Элизабет 
eliza	Элиза 
elliot	Эллиот 
eloise	Элоиза 
elongated	удлиненный 
elsewhere	в другом месте 
else	еще, кроме
elton	Эльтон 
el	Эль
embark	садиться на корабль
embarrassment	затруднение 
embarrass	смущать
embedded	вложенный 
embrace	обнимать, включать
embroidery	вышивка
emerald	изумруд
emerged	появился 
emergency	крайняя необходимость
emerge	появляться, выясняться, возникать (не appear)
eminent	выдающийся
emma	Эмма 
emotional	эмоциональный
emotions	Эмоции 
emotion	возбуждение
emperor	император
emphasis	подчеркивание, ударение, выразительность
empire	империя, господство
employed	используемый 
employee	служащий, работник
employer	наниматель
employment	служба, занятие (не occupation, profession)
employ	держать на работе, нанимать
empty	пустой
emulation	соревнование
enabled	позволил 
enable	давать возможность, делать возможным
enamel	эмаль, глазурь
encampment	лагерь
enclosed	приложенный (не embedded, attached) 
enclose	окружать
encounter	встретить, сталкиваться
encouraged	поощренный 
encouragement	ободрение
encourage	ободрять, поощрять, подстрекать
encyclopedia	энциклопедия
endanger	подвергать опасности
endeavour	попытка
ended	законченный 
ending	окончание, завершение
endlessly	нескончаемо
endless	бесконечный
endurance	выносливость, терпение (не tolerance)
endure	вынести 
end	конец
enemies	враги 
enemy	враг, противник
energy	энергия, сила
enforce	принуждать, навязывать, проводить в жизнь
engaged	занятый, помолвленный (от engage)
engagement	занятие
engage	нанимать, занимать, вовлекать (не employ)
enginedriver	машинист
engineering	техника, машиностроение, махинации
engineer	инженер
engine	двигатель, мотор, машина
England	англия
English	английский язык, английский
enhanced	увеличенный 
enhancements	повышения 
enjoyed	получил удовольствие (от enjoy)
enjoyment	удовольствие, наслаждение, обладание
enjoy	любить, получать удовольствие
enlarge	увеличивать, расширять, распространяться **l****
enlighten	просвещать
enormously	чрезвычайно
enormous	громадный, ужасный
enough	достаточный
enquired	спрашивал
enslave	порабощать
ensued	последовал 
ensure	обеспечивать, гарантировать
entangled	запутанный
entered	поступил (от enter)
entering	вступление
enterprise	предприятие, предприимчивость
enterprising	предприимчивый
entertained	развлекал 
entertainment	развлечение
entertain	развлекать, развлечь
enter	входить, поступать (enter)
enthusiasm	энтузиазм, восторг
enthusiastic	восторженный
entirely	совершенно, полностью, исключительно
entire	полный, совершенный
entitled	имеющий право 
entrance	вход
entreaty	мольба (prayment  нет такого слова)
entry	вход
enumerate	перечислять
envelope	конверт
envious	завистливый (не jealous)
environment	окружающая среда
envy	зависть, завидовать
epidemic	эпидемический, эпидемия
episode	эпизод
equality	равенство, равноправие
equally	поровну, одинаково, в равной степени
equal	равный
equator	экватор
equipment	снаряжение, оборудование
erase	стирать (резинкой)
era	эра
erect	строить (не build)
ere	до, перед, прежде чем; скорее чем 
ernest	Эрнест 
ernie	ерни 
errand	поручение
erring	грешный, заблудший
erroneous	ошибочный
errors	ошибки 
error	ошибка
err	допустить ошибку 
er	отделение (служба) экстренной медицинской помощи (Emergency Room) ((!NEW!))
escape	избежать, избегать
escort	охрана (не guards)
especially	особенно
essay	очерк
essence	сущность
essential	обязательный, существенный, важный
established	установленный
establishment	установление, учреждение, положение
establish	учреждать, создавать, утверждать
estate	поместье, имущество, сословие
estate	поместье, имущество, сословие
esteem	уважать, почитать, уважение (не regard)
estimated	предполагаемый
estimate	оценка, проект, оценивать
etc	и т.д 
eternal	вечный (не forever)
ethel	етел 
Et	и 
Eugene	Юджин 
european	европейский
Europe	европа
evaluation	оценка (не estimation)
evaporate	испаряться, выпаривать
evenings	вечерние (спектакли)
evening	вечер
eventful	полный событий, знаменательный
events	события 
eventually	в конечном счете, в конце концов
event	событие
even	даже
everybody	каждый, всякий, все
everyday	повседневный
everyone	все, каждый, всякий
everything	все
everywhere	всюду, везде
every	каждый
ever	когда-либо
evidence	доказательство
evidently	очевидно
evident	очевидный, ясный
evil	зло, злой
evolution	развитие 
exactly	точно, именно
exact	точный
examination	экзамен
examine	рассматривать, рассмотреть
examples	примеры 
example	пример, образец (не pattern)
exams	экзамены (от exam)
exam	экзамен
exasperation	раздражение, ожесточение
excavator	экскаватор
exceedingly	чрезвычайно
exceed	превышать, превосходить
excellent	превосходный, отличный
excepting	за исключением
exception	исключение
except	исключая, кроме
excessively	чрезмерно 
excess	избыток
exchanged	обменивал (от exchange)
exchange	обмен, обменивать
excitedly	взволнованно (не thrilling) 
excited	взволнованный, возбуждённый
excitement	возбуждение
excite	возбуждать, волновать
exciting	волнующий, великолепный
exclaim	восклицать
exclamation	восклицание
exclude	исключать
exclusively	исключительно
exclusive	исключительный, недоступный
excursion	экскурсия
excuse	извинять
executed	выполненный 
execute	выполнять
execution	выполнение
exercise	упражнение
exertion	напряжение, усилие
exert	напрягать(силы)
exhausted	изнуренный
exhaust	исчерпывать, истощать, выхлоп (тех.)
exhibited	показанный (не displayed) 
exhibition	выставка
exhibit	экспонат, показывать
existence	существование
existing	существующий
exists	существует 
exist	существовать, жить
exit	выход, выезд
expanded	расширенный (не extended) 
expansion	расширение, распространение
expectations	ожидания (от expectation)
expectation	ожидание
expected	предполагаемый, ожидаемый
expecting	ожидающий (от expect)
expect	ожидать
expedition	экспедиция
expelled	удаленный 
expel	изгонять, исключать
expense	расход
expensive	дорогой
experienced	опытный
experience	опыт
experimental	экспериментальный
experiments	Эксперименты 
experiment	эксперимент
expert	эксперт
explained	объяснил (от explain)
explain	объяснять
explanation	объяснение
explicit	ясный
explode	взрывать, подрывать
exploit	эксплуатировать
exploration	исследование
explore	исследовать
explosion	взрыв, вспышка
explosive	взрывчатый, взрывчатое вещество
export	экспорт, экспортировать
exposed	выставленный(подвергнутый) 
expose	выставлять, подвергать, разоблачать
exposure	подвергание 
expressing	выраженный
expression	выразительность, выражение
expressive	выразительный
express	экспресс, выражать
expulsion	изгнание (не dejection)
exquisite	изысканный
extended	растянутый
extending	распространение(продление) 
extend	продлевать, растягивать
extension	расширение
extensive	обширный
extent	протяжение
exterior	внешний, внешность, внешний вид
external	наружный
extinct	потухший (о вулкане), вымерший
extract	удалять, извлекать; экстракт, выдержка (из книги)
extraordinary	необычный
extra	сверх (не above)
extremely	крайне
extreme	чрезвычайный, крайность
extremity	конец, край, крайность, конечности
eyebrows	брови ((!NEW!))
eyebrow	бровь
eye	глаз
fable	басня, сюжет
faces	выходит, стоит лицом (от face)
face	лицо
facilitate	облегчать
facility	легкость, способность, умение
facing	сидящий лицом (от face)
fact	сущность, факт
faded	исчез 
fade	увядать
failed	потерпел неудачу, не удалось (от fail)
failing	неудача
failure	неудача
fail	недоставать, не хватать;  обмануть ожидания
faintest	малейший (от faint)
faintly	слабо (!NEW!)
faint	слабый
fairfax	фаирфакс 
fairly	довольно (не rather)
fairy	волшебный
fair	любезно, хорошо, справедливый
faithfully	искренне 
faithful	верный
faithless	ненадежный
faith	вера
fake	подделка (!NEW!)
falcon	сокол
fallen	упавший (!NEW!)
falling	падение
fall	падать
false	ложный
fame	слава, известность
familiar	близкий
family	семья
famine	голод (не hanger)
famous	известный
fancied	представлял себе 
fancy	воображать, представлять себе
fangs	клыки 
fang	клык, корень зуба, зубец
fanny	фанни 
fantastic	фантастический
fantasy	воображение
fan	болельщик, поклонник
farewell	прощание; прощайте! до свидания!
farmer	фермер
farm	ферма
farrier	кузнец 
farther	дальше
far	далеко
fascinated	очаровал (от fascinate)
fashionable	модный
fashioned	вылепленный 
fashion	мода
fastened	закрепленный (не attached) 
fasten	прикреплять
faster	быстрее
fast	спешащий, сильно, быстро (fast)
fatal	фатальный
fate	судьба
father	папа
fatigue	усталость, утомлять(ся)
fatty	жирный (!NEW!)
fat	жирный
faucet	водопроводный кран, вентиль
faults	ошибки
fault	вина, недостаток, ошибка
favorite	любимый (!NEW!)
favor	польза(покровительство) 
favourable	благоприятный
favourite	любимый
favour	одолжение, услуга, польза
fearful	страшный
fear	страх, опасение, бояться, опасаться
feasible	осуществимый
feast	пир
feathers	перья (!NEW!)
feather	предмет гордости, достижение
features	особенности 
feature	особенность, характерная черта
feat	подвиг, ловкость, искусство
February	февраль
fed	кормивший(питаемый) 
feeble	слабый, бледный
feeding	питание
feed	кормить
feelings	страсти (от feeling)
feeling	чувство, чувствующий (от feel)
feels	чувства 
feel	чувствовать
feet	ноги, ступни
fee	гонорар, платить гонорар
fellow	человек, парень, приятель
fell	упал (от fall)
felt	чувствовал (от feel)
females	Женщины 
female	женщина, самка
feminine	женский, женского рода (грам.)
fence	забор
fencing	ограждение
feral	дикий (не от слова wild) 
ferment	закваска, фермент; бродить (о вине, варенье)
ferocious	дикий
ferocity	свирепость
ferry	перевоз
fertile	плодородный
fertilised	оплодотворенный 
fertility	изобилие (не abundance) 
fertilizer	удобрение
festival	праздник, фестиваль
fetched	принесённый, достанный (!NEW!)
fetch	приносить
fever	жар, лихорадка
few	мало
fickle	непостоянный, изменчивый
fiddlesticks	вздор
field	поле
fiend	дьявол, злой дух (не devil)
fierce	свирепый
fiery	пламенный 
fifteenth	пятнадцатый
fifteen	пятнадцать
fifth	пятый
fifty	пятьдесят
fighting	бой, сражение
fight	бороться, бой
figured	изображенный 
figure	фигура
fig	рис. 
filament	нить 
filch	украсть (не steal) 
files	файлы 
file	картотека
filling	заполнение, наполнение
fill	заполнить, наполнить
film	фотопленка, фильм
filter	фильтр; фильтровать, просачиваться
finalize	завершать
finally	в конце концов
final	окончательный
financial	финансовый
finding	находка, открытие, решение
finds	находит 
find	найти, находить
fined	штрафовал, оштрафованный (от fine)
finest	самый прекрасный 
fine	прекрасно, прекрасный
finger	палец
finished	закончил (от finish)
finishing	завершение
finish	кончать(ся), заканчивать(ся), конец, финиш
fin	плавник
fireplace	камин 
fires	огни(пожары) 
firewood	дрова
fireworks	фейерверк
fire	огонь, пожар
firing	увольнение(обстрел)
firmly	твердо, решительно
firm	фирма, твердый, твердо, крепко
first	первый
fir	пихта, ель
fisherman	рыбак
fishing	рыбная ловля
fishy	подозрительный, сомнительный
fish	рыба
fist	кулак
fitness	годность
fits	подходит (от fit)
fitting	примерка
fit	подходить, соответствовать, устраивать
five	пять
fixed	назначил (от fix)
fixes	устанавливает 
fix	починить, наладить, назначить
flabbergasted	поражен, изумлен
flag	флаг
flakes	хлопья
flames	огонь 
flame	пламя (не blaze)
flaming	пылающий
flank	фланг
flannel	фланель
flap	развеваться, взмахивать (крыльями); взмах (крыльев), клапан
flare	вспыхивать; вспышка, осветительная ракета (не flash)
flashlights	прожектора 
flashlight	карманный фонарь (!NEW!)
flash	вспышка, сверкать
flask	фляжка
flattering	льстивый, лестный
flatter	льстить
flat	квартира, плоский
flavour	вкус, аромат
flaw	изъян, недостаток (не lack)
flax	лен, льняное полотно
flea	блоха
fled	убегал, спасался бегством (!NEW!)
fleet	флот
flee	бежать
flesh	тело, плоть, мясо
flew	летал (от fly)
flexible	гибкий
flight	полет
flinch	отступать, вздрагивать
fling	бросать(ся), швырять(ся)
flint	кремень 
float	плавать, поплавок
flock	стадо, стая
flood	наводнение
floored	поставил в тупик, сразил (от floor)
floor	пол, этаж; одолеть, смутить
flora	флора 
flourishing	цветущий
flourish	процветать, размахивать; росчерк
flour	мука
flowerbed	клумба
flowery	цветистый
flower	цветок
flowing	течение
flow	течение, поток, разливаться, течь
fluently	бегло, гладко
fluid	жидкий, жидкость
flung	бросал, швырял (не threw) (!NEW!)
flurry	будоражить
flush	(по)краснеть
flutter	махать
flu	грипп
flying	летающий, летный (от fly)
fly	летать
fly	летать
foal	жеребенок
foam	пена
focus	фокусировать
fodder	фураж, корм
foe	враг
foggy	туманный
fog	туман
folded	складчатый (не crease) (!NEW!)
folder	папка (для дел), брошюра (амер.)
folding	складной
fold	складывать, сгибать, скрещивать (руки); складка
foliage	листва
folks	люди 
folk	народная
following	следующий
follows	следует 
follow	следовать
folly	глупость
fond	нежный
food	пища (не meal)
foolish	глупый
fool	дурак, глупец
football	футбол
footprints	следы (!NEW!)
footprint	след 
footstep	звук шагов, след ноги
foot	нога, фут
forbes	форбес 
forbidden	запрещенным 
forbid	запрещать
forced	принудительный, принужденный
force	сила
forcible	насильственный, убедительный
ford	брод, переходить вброд (не wade)
foregoing	предшествующий (не preceding)
foreground	передний план
forehead	лоб
foreigner	иностранец
foreign	иностранный
foreman	мастер, старший рабочий, техник, прораб
foremost	передовой
forepaws	передние лапы 
foresight	предвидение, предусмотрительность
forester	лесник 
forests	леса 
forest	лес
forever	вечно (!NEW!)
foreword	предисловие
fore	передний
forgery	подделка, подлог
forgetful	забывчивый
forget	забыть
forge	выдумывать
forgive	прощать
forgotten	забытый (от forget)
forgot	забыл (от forget)
fork	вилка
fork	вилка
formally	формально
formal	официальный, формальный
formation	образование, структура, формирование
formed	сформировавшийся, организованный
formerly	прежде, некогда
former	бывший
formidable	внушительный (не tremendous)
forming	формирование 
forms	формы (от form)
formula	формула
form	бланк, форма, формировать
forthwith	тотчас, немедленно
forth	вперед, впредь, далее
fortitude	стойкость, мужество
fortnight	две недели
fortress	крепость
fortunately	к счастью
fortunate	счастливый
fortunes	благосостояния (не welfares) 
fortune	удача, счастье
forty	сорок
fort	форт 
forward	передовой, вперед, впредь
for	для, за, на
fossil	ископаемое
foster	воспитывать
fought	сражался (!NEW!)
foul	загрязненный, грязный, бесчестный
foundation	основание
found	нашел, найденный (от find)
fountain	источник, фонтан
fourteenth	четырнадцатый
fourteen	четырнадцать
fourth	четвертый
four	четыре
fowls	домашние птицы 
fowl	птица (домашняя)
fox	лиса
fraction	дробь, частица
fracture	перелом, излом; ломать
fragile	хрупкий
fragment	отрывок, обрывок
frail	хрупкий, хилый
frames	оправы, рамки (от frame)
framework	каркас
frame	оправа, рамка
France	франция
frankly	откровенно
frank	искренний, откровенный, открытый
frantically	неистово (!NEW!)
frantic	неистовый
franz	франз 
fraud	обман, фальшивка
fray	шумная ссора, обтрепываться
freakish	капризный, причудливый
freedom	свобода
freely	свободно
freeman	полноправный гражданин (!NEW!)
freeze	замерзать
freezing	замерзание
free	свободный
freight	груз, грузовой
French	французский
frequently	часто
frequent	частый
fresh	свежий, бодрый
Friday	пятница
fried	жареный
friendly	дружеский, дружелюбный
friendship	дружба
friends	друзья (от friend)
friend	друг
frighten	пугать
frightful	страшный, ужасный
fright	испуг
fringe	бахрома, край
fritter	пончик, крошить
frog	лягушка
frolic	веселиться, проказничать
from	от, из
frontier	граница
front	перед, передняя сторона, фронт
frosty	морозный
frost	мороз
frown	нахмуриться, недовольное выражение лица
fro	обратно (!NEW!)
fruitless	бесплодный
fruit	фрукты
frustration	расстройство
fry	(за)жарить
fudge	глупость, чушь
fuel	топливо, горючее
fugitive	беглый, мимолетный, беглец
fulfil	выполнить
fully	вполне, полностью
full	полный
functions	функции 
function	функция, торжество
fund	фонд
funeral	похороны, похоронный
funnel	воронка, труба (паровоза, парохода)
funny	смешной, забавный
fun	шутка, веселье
furious	взбешенный, бешеный, неистовый
furnace	печь, топка, горн
furnished	снаряженный, оборудованный, экипированный (!NEW!)
furnish	снабжать, меблировать, обставлять
furniture	мебель
furrow	борозда, колея
furry	пушистый (не downy)
furs	меха (от fur)
furthermore	кроме того
further	дальнейший, дополнительный
fury	неистовство
fur	мех, шкура
fuse	плавить(ся), сплавлять(ся), перегорать
fuss	суета; суетиться, беспокоиться, хлопотать  (не stir)
futile	бесполезный, тщетный, пустой (о человеке)
future	будущее
gag	затычка, кляп
gaily	весело, оживленно (g  первая буква)
gained	полученный 
gain	прибыль
galactic	галактический 
galaxy	галактика 
gale	шторм
gallant	доблестный, отважный, смелый, храбрый
gallery	галерея
games	игры (от game)
game	игра
gangster	бандит, гангстер
gang	шайка, банда
gap	брешь
garage	гараж
garbage	мусор
gardener	садовник
gardening	садоводство
garden	сад
gargling	полоскающий (от gargle)
garlic	чеснок
garments	предметы одежды 
garment	одежда, одеяние
garret	мансарда, чердак
garrison	гарнизон, ставить гарнизон
gasoline	газолин, бензин (амер.)
gasped	задыхался (не от слова pant) 
gasp	задыхаться (не pant)
gas	газ
gates	стойки (от gate)
gate	ворота, проход
gathering	собрание, сборище
gather	собираться
gaunt	изможденный 
gave	дал (от give)
gay	веселый
gaze	пристально глядеть, пристальный взгляд
gear	механизм
gem	драгоценный камень
generally	вообще, обычно
general	общий
generate	порождать
generations	поколения 
generation	поколение
generator	генератор 
generosity	благородство, щедрость
generous	великодушный
gene	ген
genius	гений
gentleman	господин, джентльмен
gentlemen	господа (от gentleman)
gentle	нежный, ласковый
gently	мягко, кротко
genuine	подлинный
genus	род 
Geoffrey	джеффри 
geoff	джеф 
geographical	географический
geological	геологический 
geology	геология
geometry	геометрия
georgiana	георгиана 
Germany	германия 
German	немец 
germ	зародыш (биолог.), микроб
gesture	жест
gets	действует (от get)
getting	передвижение
get	получать, доставать, достигать, добраться
ghosts	призраки 
ghost	привидение, дух
giant	гигант, гигантский
gifted	одаренный
gift	подарок
gigantic	гигантский
Ginny	гинни 
Gipsy	цыганский, цыган(ка)
girl	девочка, девушка
given	данный (от give)
give	давать
glacier	ледник, глетчер
gladly	с удовольствием 
glad	рад
glanced	поглядел 
glance	взглянуть, мелькнуть
glancing	глядящий
glands	гланды 
gland	железа
glare	сверкать
glasses	очки
glass	стакан, бокал
glass	стакан, бокал
gleamed	мерцал (не blinked) 
gleaming	блеск
gleam	проблеск, светиться
glide	скользить, планировать (авиа)
glimpse	мелькание, мельком взглянуть (!NEW!)
glittering	сверкание
glitter	блеск, блестеть
globe	земной шар, глобус
gloomily	уныло (не ruefully) 
gloomy	мрачный (не dreary)
gloom	мрак, уныние
gloria	глория 
glorious	великолепный, славный
glory	слава
glossy	глянцевитый, блестящий (о волосах)
gloves	перчатки (от glove)
glove	перчатка
glowing	пылающий
glow	сильный жар, накаляться (не heat)
glue	клей; клеить, приклеивать
gnaw	грызть, глодать
goal	цель, гол
goats	козлы 
goat	козел, коза
god	бог, божество
goes	идет (от go)
going	идущий (от go)
golan	голанский 
golden	золотой, золотистый
gold	золото, золотой
goodbye	прощание
goodness	доброта; великодушие; любезность (!NEW!)
goods	товары
goodwill	добрая воля
good	хороший, добрый, добро, польза
goon	придурок (!NEW!)
gooseberry	крыжовник
goose	гусь
gosh	боже (!NEW!)
gossip	сплетня
gos	идет 
got	получил, полученный (от get)
government	правительство
governor	губернатор
govern	управлять
gown	платье
go	идти
grabbed	захваченный 
grab	внезапно схватывать
graceful	грациозный
grace	грация, изящество
gracious	милосердный
grade	сортировать, степень
gradually	постепенно
gradual	постепенно
graduated	окончил, окончивший учебное заведение (от graduate)
grains	зерно
grain	зерно
grammar	грамматика
gram	грамм
grandchildren	внуки
grandeur	величие, великолепие, грандиозность
grandfather	дедушка
grandmother	бабушка
grandparents	дедушка и бабушка
grandson	внук
grand	величественный
granite	гранит
granted	дарованный (!NEW!)
grant	дарить, дар
grapes	виноград
graphic	графический, наглядный, образный
grasp	понять, схватить
grasshopper	кузнечик
grass	трава
grateful	благодарный
grater	терка
grate	каминная решетка
gratified	удовлетворенный
gratitude	благодарность
gravely	серьезно, здраво, рассудительно
gravel	гравий
graveyard	кладбище 
grave	могила, серьезный, важный
gravity	серьезность
gravy	подливка, соус
gray	серый 
graze	задевать, оцарапать, содрать (кожу)
grease	жир, сало, мазь, смазка; смазывать (жиром)
greasy	жирный, сальный
greater	больше (!NEW!)
greatest	самый большой (от great)
greatly	очень
great	великий
greedy	жадный
Greek	грек 
greenhouse	оранжерея 
green	зеленый
greeted	приветствовал (от greet)
greetings	приветствия (от greeting)
greeting	приветствие, поклон
greet	приветствовать
grew	рос (от grow)
grey	серый
gride	скрип (не creak) 
grief	горе
grieved	огорченный 
grievously	горестно
grill	решетка
grimly	жестоко, решительно (!NEW!)
grim	жестокий, свирепый, мрачный
grind	молоть, толочь, точить
grin	ухмыляться, усмешка
grip	схватывание
groan	стон, стонать
grocer	бакалейщик
gross	большой (не large)
grotesque	преувеличение
grounds	основания(земля) 
ground	земля
grouping	классификация
groups	группы 
group	группа
growing	растущий
growled	рычал 
growl	рычать, ворчать; рычание, ворчание
grown	выращенный (от grow)
growth	рост
grow	расти
grudge	завидовать, жалеть (время, деньги)
grumble	ворчать
grunt	хрюкать, хрюканье
guarantee	гарантия, гарантировать
guarded	охраняемый 
guardian	опекун, попечитель
guards	охраны 
guard	охрана, стража
guessing	гадание
guess	отгадывать, догадка
guests	гости (от guest)
guest	гость
guffaw	хохот
guidance	руководство
guided	управляемый(руководствуемый) 
guide	гид, экскурсовод
guilty	виноватый
guilt	вина, виновность
guinea	гинея (золотая монета, денежная единица; = 21 шиллингу)
gulf	залив, бухта
gull	чайка
gulped	проглоченный 
gums	десны
gum	смола, клей; склеивать(ся) (не tar)
gunpowder	порох
gun	ружье, пушка
gurgle	бульканье
gust	порыв (ветра)
gus	гас 
gutter	водосточный желоб, канава
guy	парень
habits	привычки 
habit	привычка
had	вспомогательный глагол, имел (от have), не has
hail	приветствовать
hairpin	шпилька
hairs	волосы 
hairy	волосатый
hair	волосы
halfway	на полпути (!NEW!)
half	половина
hall	зал
halted	приостановленный
halt	остановка, останавливать (не stop)
hammer	молоток
hammock	гамак
hamper	препятствие
ham	ветчина
handbag	дамская сумочка
handbook	справочник, руководство (не guidance)
handful	горсть
handkerchief	носовой платок
handled	обработанный 
handle	обращаться с, управлять (не manage)
handling	обращение
handsome	красивый
hands	руки (от hand)
handy	удобный; ловкий, искусный
hand	рука
hanging	подвешивание
hang	повесить, висеть
hanky	носовой платок (!NEW!)
hannah	Ханна 
Hans	Ханьшуй 
happened	случился (от happen)
happening	случай, событие
happen	случаться, происходить
happily	счастливо
happiness	счастье
happy	счастливый
harassment	беспокойство
harass	беспокоить
harbour	гавань
harden	твердеть
harder	больше, упорнее (от hard)
hardly	едва (не barely, merely)
hardship	лишение
hardworking	трудолюбивый
hard	с трудом, тяжело
hare	заяц
hari	Хари 
harmless	безвредный, безобидный
harmony	гармония, согласованность
harm	беда, неприятность
harness	упряжь, запрягать
harold	гарольд 
harp	арфа
harriet	гарриет 
harshly	грубо, резко
harsh	грубый, резкий (не sharp)
hart	олень
harvest	урожай
hastened	поторопленный (!NEW!)
hasten	торопить(ся)
haste	спешка
hastily	поспешно, опрометчиво
hasty	поспешный, необдуманный
has	имеет (от have)
hatchet	топор(ик)
hatch	высиживать
hated	ненавидел (от hate)
hateful	ненавистный
hate	ненавидеть
hatred	ненависть
hats	шляпы 
hat	шляпа
haughty	высокомерный, надменный
hauled	буксируемый 
haul	тянуть (не pull)
haunted	часто посещаемый 
haunt	преследовать (о мыслях), появляться (как призрак)
haven	гавань, убежище
have	иметь, вспомогательный глагол
having	имеющий, обладающий (от have)
hay	сено
hazard	шанс, опасность
haze	легкий туман (не mist)
headache	головная боль
header	удар головой 
heading	заголовок
headless	безголовый 
headlight	фара (автомобиля), огни (паровоза)
headline	заголовок
headlong	очертя голову
headmaster	директор школы 
headphones	наушники
headquarters	штаб
headstone	надгробный камень 
heads	головы (от head)
head	голова, главный, руководить
healthy	здоровый
health	здоровье
heal	излечивать
heap	куча
heard	слушал, услышанный (от hear)
hearing	слух
hearth	печь, камин, домашний очаг
heartily	сердечно
hearty	искренний, (чисто)сердечный, радушный
heart	сердце
hear	слышать
heating	отопление
heat	жара
heaven	небо, небеса, бог, провидение
heavily	тяжело
heavy	тяжелый
hedgehog	еж
hedge	ограда
Hedwig	Хедвиг 
heedless	невнимательный, небрежный
heed	внимание, слушать внимательно
heels	пятки (!NEW!)
heel	пятка, каблук
height	высота
heir	наследник
held	держал (!NEW!)
helium	гелий 
hello	привет
hell	черт
helmet	шлем, каска
helm	руль
helped	помогал (от help)
helpful	полезный
helping	помощь
helpless	беспомощный
help	помощь, помогать
hemp	конопля, пенька
hem	рубец, кромка, кайма; подшивать, подрубать
henceforward	впредь, отныне
hence	следовательно
henrietta	генриетта 
hen	курица
herd	стадо
hereafter	после этого(в будущем) (не afterward) 
hereditary	наследственный
herein	в этом, при сем
here	здесь, вот
hermione	Хермион 
hermit	отшельник
heroic	героический
heroism	героизм, доблесть
heron	цапля
hero	герой
herring	сельдь
herself	себя
hers	ее
her	ее, ей
hesitate	колебаться
hesitation	колебание 
hey	эй (!NEW!)
he	он
hick	провинциал, деревенщина (!NEW!)
hideous	безобразный, уродливый, страшный (не fearful)
hide	прятать, спрятать
higher	выше
highly	очень, весьма
highness	высота, возвышенность (не altitude)
highway	большая дорога, шоссе
high	высокий
hike	путешествовать пешком
hiking	пеший поход
hillside	склон 
hills	Холмы 
hill	холм, гора
himself	себя, себе, сам
him	его, ему
hinder	препятствовать, мешать
hinge	петля, шарнир; висеть, вращаться на петлях
hint	намек, намекать
hip	ягода шиповника
hire	взять напрокат
hissed	шипящий (
hiss	свистеть, шипеть, свист
historical	исторический
historic	исторический
history	история
hist	тише!, тс! 
his	его (
hitherto	до сих пор
hit	успех, удача, попадать в цель
hive	улей
Hi	привет
hoard	запас; запасать, копить (не spare, stock)
hoarse	хриплый
hoax	разыгрывать
hobble	хромота, прихрамывать, ковылять
hobby	хобби
hockey	хоккей
hoe	мотыга, рыхлить землю
hog	свинья, боров
hoist	поднимать (флаг, парус)
holder	владелец, ручка, рукоятка
holding	удерживание, держащий (от hold)
holds	держится 
hold	держать(ся), выдерживать, захват, владение
Holes	отверстия 
hole	отверстие, яма
holidays	каникулы (не vacation)
holiday	отпуск, праздник
hollow	пустой
hols	каникулы, отпуск (!NEW!)
holy	священный, святой
homes	дома (от home)
homework	домашнее задание
home	дом
honestly	честно (!NEW!)
honest	честный
honeycomb	соты
honey	мед
honorable	благородный 
honorary	почетный
honor	честь 
honourable	почетный, почтенный, честный
honoured	чтимый(удостоенный) 
honour	честь
hood	капюшон, капор, колпак, крышка (тех.)
hoof	копыто
hooker	проститутка 
hookup	соединение 
hook	крючок
hoop	обруч
hooter	гудок (не buzzer) 
hoped	надеялся (от hope)
hopefully	с надеждой (!NEW!)
hopeful	надеющийся, подающий надежды, многообещающий
hopeless	безнадежный
hopes	надежды 
hope	надеяться
hopped	прыгал (не sprang, leaped, jumped) 
hopper	бункер 
hop	хмель (бот.)
horace	Хорас 
horizontally	горизонтально 
horizontal	горизонтальный
horizon	горизонт
horns	рожки 
horn	рог, забодать
horrible	ужасный
horrid	ужасный
horror	ужас
horseman	наездник
horse	лошадь
hose	чулки
hospitality	гостеприимство
hospital	больница
hospital	больница
hostess	хозяйка
hostile	враждебный (не adverse)
hostility	враждебность (не adversity)
host	хозяин
hotel	гостиница
hotter	жарче (от hot)
hot	горячий
hours	часы (от hour)
hour	час
household	домашнее хозяйство
housekeeper	экономка
housewife	домашняя хозяйка
housework	работа по дому
house	дом
hover	парить, вертеться
however	однако
howl	выть, вой (не wail)
how	как
HRS	часы 
huge	огромный (не bulk)
hugo	Хьюго 
hug	крепко обнимать
humanity	человечество
human	человеческий
humble	скромный
humbug	обманщик, ханжа
humorous	смешной
humor	юмор
humour	юмор, настроение
hump	горб
hum	жужжать, гудеть
hunchback	горбун
hundreds	сотни 
hundredth	сотый
hundred	сто
hunger	голод
hungry	голодный (не от слова starve)
hung	вешал, был склонным (!NEW!)
hunter	охотник
hunting	охота
hunt	охотиться
hurricane	ураган
hurriedly	поспешно (!NEW!)
hurried	спешил, торопился (от hurry)
hurry	спешить, торопиться, спешка
hurts	болеет, причиняет боль, повреждает (от hurt)
hurt	рана, болеть, причинить боль, повредить
husband	муж
hush	водворять тишину
hut	хижина
hybrids	гибриды 
hybrid	гибрид 
hygienic	гигиенический
hypothesis	гипотеза 
hysteria	истерия
hysterical	истерический
icebox	холодильник (морозильник) (не fridge)
ice	лед
icicle	сосулька
icy	ледяной
ideal	идеал, идеальный
idea	идея, мысль
identical	тождественный
identification	отождествление
identifiers	идентификаторы 
identifier	идентификатор 
identify	опознавать, распознавать; устанавливать личность
idiot	идиот
idle	бесполезный
if	если
ignition	зажигание, воспламенение
ignorance	незнание, невежество
ignorant	невежественный, неосведомленный, несведущий
ignore	игнорировать
illegal	нелегальный
illiterate	неграмотный
illness	болезнь
illuminated	освещенный 
illuminate	освещать
illumination	освещение
illusion	иллюзия
illustration	иллюстрация 
ill	больной
image	изображение, образ, имидж
imagination	воображение
imagine	думать, воображать
imitate	подражать
imitation	подражание, имитация
immediately	немедленно
immediate	непосредственный
immensely	чрезвычайно
immense	громадный, необъятный
immersed	погруженный 
imminent	надвигающийся
immortal	бессмертный
impact	удар (не stroke)
impatience	нетерпение
impatiently	нетерпеливо
impatient	нетерпеливый
impediment	препятствие
impenetrable	непроницаемый
imperative	повелительное наклонение (грам.)
imperfect	несовершенный
imperial	имперский 
impertinence	дерзость
implementation	выполнение 
implemented	осуществленный 
implement	выполнять
implied	подразумеваемый
impolite	невежливый, неучтивый
importance	важность
important	важный
import	импорт, ввоз
impose	налагать
impossible	невозможный
impostor	самозванец, плут
impression	впечатление
impressive	впечатляющий
impress	производить впечатление
imprison	заключать в тюрьму
improbable	невероятный
improved	улучшил (от improve)
improvements	усовершенствования 
improvement	улучшение
improve	улучшать
impulse	побуждение, порыв
impure	нечистый, грязный, с примесью
inability	неспособность
inaccessible	недоступный
incessant	непрерывный, вечный
inches	дюймы 
inch	дюйм
incidentally	между прочим
incident	инцидент
inclination	склонность
inclined	наклонный
incline	склонять
included	включенный (от include)
include	включать
including	включая
inclusion	включение
income	доход, заработок
incomprehensible	непонятный, непостижимый
inconsistent	непоследовательный
inconvenient	неудобный
incorrect	неверный, неправильный
increase	рост
increasingly	все больше и больше
increasing	возрастающий
incredible	невероятно
incur	подвергаться
indebted	обязанный
indeed	неужели, действительно (не really)
indefinite	неопределенный, неограниченный
independence	независимость
independently	независимо
independent	независимый
indexes	индексы 
index	индекс, указатель, показатель
indians	индусы(индейцы) 
indicate	показывать, указывать
indices	индексы (не indexes) 
indifference	безразличие
indifferent	безразличный
indigenous	местный
indigestion	несварение, расстройство
indignant	негодующий, возмущенный
indignation	негодование, возмущение
indirect	косвенный
individual	личность, индивидуальный
indolent	ленивый, праздный, безболезненный
indoors	в помещении
induced	вынужденный(вызванный) 
induce	убеждать
industrial	промышленный
industrious	трудолюбивый, прилежный (не hardworking)
industry	промышленность
ineffective	неэффективный
inevitable	неизбежный
infant	младенец
inferior	худший, плохой
infer	заключать, делать вывод
infinitely	бесконечно
infinite	безграничный, бесконечный
inflected	склоняемый 
inflection	сгибание 
inflict	наносить удар
influenced	влиял (от influence)
influence	влияние, влиять
information	информация
informed	осведомленный
informs	сообщает 
inform	сообщать
info	информация 
inga	инга 
ingenious	изобретательный, остроумный, находчивый
ingratitude	неблагодарность
ingredient	составная часть
inhabitants	Жители 
inhabitant	житель
inhabited	населенный
inhabit	жить, обитать
inhale	вдыхать
inherent	неотъемлемый, присущий, свойственный (не Integral)
inheritance	наследство
inherited	унаследованный 
inherit	(у)наследовать
initially	вначале
initial	начальный, первоначальный
initiate	начинать (не commence)
inject	впрыскивать
injunction	предписание
injured	поврежденный
injure	ушибиться
injury	телесное повреждение
injustice	несправедливость
ink	чернила
inland	внутренний
inner	внутренний
innocence	невинность, невиновность
innocent	наивный, невинный
innumerable	бесчисленный
inn	гостиница, постоялый двор
input	вход 
inquired	осведомлённый (не informed) (!NEW!)
inquire	спрашивать, узнавать
inquiries	справочное (от inquiry)
inquiry	расспросы, наведение справок
inquisitive	любопытный
insane	душевнобольной, ненормальный
inscription	надпись
insects	насекомые 
insect	насекомое
insecure	ненадежный, небезопасный (insecure)
insert	вставлять, помещать (в газете)
inside	внутрь, внутри
insignificant	незначительный, ничтожный
insist	настаивать
insolent	наглый, дерзкий, оскорбительный
inspection	осмотр
inspector	контролер, инспектор
inspect	осматривать, инспектировать
inspiration	вдохновение
inspired	вдохновленный 
installation	установка 
installed	установленный 
installer	монтажник 
installing	монтаж
installs	устанавливает 
install	водворять, устраивать, устанавливать
instances	случаи
instance	пример
instantly	немедленно
instant	мгновение
instead	вместо, взамен
instinctive	инстинктивный
instinct	инстинкт
institution	учреждение
instruction	инструкция
instructor	инструктор
instruct	инструктировать
instrument	инструмент
insufficient	недостаточный
insult	оскорбление
insurance	страхование, страховка
intake	поглощение
integer	целое число 
integral	неотъемлемый
intellectual	интеллигент
intelligence	интеллект
intelligent	умный
intended	предполагаемый
intend	намереваться
intense	интенсивный, напряженный
intentional	умышленный
intentions	намерения 
intention	намерение, замысел
intently	внимательно (!NEW!)
intent	намерение, цель
interbase	межоснова 
intercept	перехватывать
intercourse	общение
interdependent	взаимозависимый
interested	заинтересованный, интересующийся (от interest)
interesting	интересный
interest	интересовать, заинтересовывать
interface	интерфейс 
interference	вмешательство
interfere	мешать
interfering	вмешательство
interior	внутренний (не internal)
intermediate	промежуточное звено 
internal	внутренний
international	международный
interposed	вставленный 
interpret	интерпретировать, переводить(устно)
interruption	прерывание
interrupt	прерывать, мешать
intervals	интервалы 
interval	антракт, промежуток
intervention	посредничество
interview	встреча, беседа
intimate	глубокий, интимный
intimidate	пугать, запугивать
intolerable	невыносимый, нестерпимый
into	в
intricate	запутанный (не entangled)
intrigue	интрига
introduce	предстaвлять, знакомить
introduction	введение
intrude	вторгаться, вмешиваться, навязываться
invader	захватчик
invade	вторгаться
invalid	недействительный (не Illegal)
invaluable	неоценимый
invariably	неизменно
invention	выдумка, изобретательность
inventory	опись
inventor	изобретатель
invent	изобретать, изобрести
investigate	исследовать
investigation	исследование
investigator	исследователь
invest	вкладывать, помещать (капитал)
invisible	невидимый
invitations	приглашения (от invitation)
invitation	приглашение
invited	пригласил, приглашенный (от invite)
invite	приглашать
involuntary	невольный
involved	сложный
involve	втягивать, вовлекать
inward	внутрь
in	в
irene	ирэн 
ironical	иронический
ironic	иронический
iron	железо, утюг
irregular	неправильный
irresistible	непреодолимый
irresolute	нерешительный
irresponsibility	безответственность
irritation	раздражение
isabella	изабелла 
island	остров
isle	остров(ок)
isobel	исобел 
isolation	изоляция
ISO	международная организация по стандартизации 
issued	выпущенный 
issues	проблемы(выпуски) 
issue	выпуск, издание, выпускать
is	есть (от be)
Italian	итальянец 
Italy	италия 
item	вещь, предмет
itself	себя, себе
its	его, ее (от it)
it	это, он, она (для предметов и животных)
ivan	иван 
ivory	слоновая кость
ivy	плющ
I	я
jackal	шакал
jacket	куртка
Jackson	джэксон 
jack	домкрат
jail	тюрьма
Jake	джейк 
James	джеймс 
jam	варенье, джем
January	январь
Jan	январь 
jar	ссора
jaws	челюсти 
jaw	челюсть
jazz	джаз
jealousy	ревность
jealous	ревнивый
jeanne	джин 
jeans	джинсы
jean	Хлопчатобумажная ткань 
jeer	насмешка
jeff	джеф 
jelly	желе
jenny	дженни 
jerk	резкий толчок, подергивание; резко толкать, дергать
jersey	джемпер (
jerusalem	иерусалим 
jessamy	джессами 
jessie	джесси 
jest	шутка; шутить, высмеивать (не joke)
jet	струя (воды, пара, газа)
jewellery	ювелирные изделия
jeweller	ювелир
jewels	драгоценности
jewel	драгоценность
Jew	еврей 
jill	джилл 
Jim	джим 
joan	джоан 
Jobs	работы (от job)
job	работа
joe	кофе (!NEW!)
joining	соединение
joint	совместный, объединенный
join	соединяться
joke	шутка, шутить
joking	шутка, шутящий (от joke)
jolly	очень, веселый
jonas	джонас 
josephine	джозефина 
joseph	джозеф 
josie	джоси 
journal	журнал
journey	путешествие
joyfully	радостно
joyful	радостный, довольный
joy	радость
jo	джо 
judged	оцененный  (не valued)
judgement	приговор, суждение
judge	судья
judgment	суждение 
jug	кувшин
jug	кувшин
juice	сок
juicy	сочный, дождливый
July	июль
jumble	толкаться
jumped	прыгал(а) (от jump)
jumper	джемпер
jump	прыгать
June	июнь
jungle	джунгли
junior	младший
junk	рухлядь (!NEW!)
jury	присяжные, жюри
justice	справедливость
justin	джастин 
justly	справедливо
just	только, всего лишь, справедливый
juvenile	юноша, подросток
kalgan	калган 
Kate	кейт 
kazan	казань 
keel	киль
keen	страстный
keeper	хранитель, смотритель, сторож
keeping	хранение, содержание, согласие (k...ing)
keep	(со)держать, сохранять
kennel	(собачья) конура, собачий питомник
kenneth	кеннет 
kept	заставил (от keep)
kerb	обочина
kernel	ядро, зерно
kettle	чайник
kettle	чайник
keyhole	замочная скважина
key	ключ
kick	пинать, пнуть
kidding	шутящий, высмеивающий (от kid)
kidnap	похищать (человека)
kidney	почка (анатом.)
kids	дети (от kid)
kid	ребенок (разг.), обманывать (сленг.)
killed	убил (от kill)
killing	убийственный (
kill	убивать
kindly	добрый, добродушный, ласково, любезно
kindness	доброта, любезность
kind	добрый, вид, род
kingdom	королевство
kings	короли 
king	король
kiss	целовать
kitchen	кухня
kitten	котенок
kitty	цель (в игре в кегли)
kit	ранец, багаж
knees	колени (!NEW!)
knee	колено
knelt	стоял на коленях (!NEW!)
knew	знал (от know)
knife	нож
knife	нож
knights	рыцари 
knight	рыцарь
knitted	вязанный, трикотажный
knit	вязать, связывать
knob	knob
knocked	стучать (2 форма)
knock	стучать, стук
knot	узел, завязывать узел (не kink)
knowing	знание, знающий
knowledge	знание
know	знать
konrad	конрад 
label	этикетка, приклеивать ярлык
laboratory	лаборатория
labor	рабочая сила 
labourer	рабочий
labour	труд, трудиться
lace	кружево, шнурок
lack	недостаток
ladder	лестница (не stairs)
laden	груженый, нагруженный, обремененный 
ladies	дамы (от lady)
Lads	парни (не guys) (!NEW!)
lady	дама, госпожа
lad	мальчик, юноша, парень (не guy)
laid	происходил, совершался (от lay)
lake	озеро
lamb	ягненок, баранина
lament	сетование, жалоба
lame	хромой
lamp	лампа
landed	земельный
landing	высадка на берег
landlady	хозяйка (дома, гостиницы) (не mistress)
landlord	домовладелец
landscape	ландшафт, пейзаж
landslide	оползень, обвал (не avalanche)
land	земля, суша, приземляться, высаживаться на берег
lane	дорожка (не road)
language	язык
lantern	фонарь
lapse	описка
lap	подол
lard	топленое свиное сало
largely	обильно
larger	больший 
largest	самый большой 
large	большой
lark	жаворонок
larva	личинка, головастик
lash	хлестать, ударять; плеть
lastly	наконец 
last	прошлый, последний, продолжаться, длиться
latch	запирать(ся)
lately	за последнее время
lateral	боковой
later	позже
latest	последний (не latter)
late	поздно
latter	последний
laughed	смеялся, хохотал (от laugh)
laughing	смех, смеющийся
laughter	смех, хохот
laugh	смех, смеяться
launching	спуск (на воду), начало
launch	начинать
laundry	прачечная, стирка
laurie	лаури 
lavish	щедрый, обильный
lawn	лужайка
laws	законы 
lawyer	адвокат, юрист
law	закон, право
laying	наложение
lay	класть, положить
laziness	лень
lazy	ленивый
la	ла 
leadership	руководство
leader	глава, лидер
leading	лидирование, руководящий
leads	лидерство 
lead	вести, руководить
leaflets	рекламные листки 
leaflet	рекламный листок 
leaf	лист
league	союз, лига
leak	просачиваться
lean	прислоняться, наклоняться, наклон
leaped	прыгал (не sprang, jumped, hopped) 
leapt	прыгал (!NEW!)
leap	високосный, прыжок, прыгать
learned	ученый
learning	учение
learnt	узнал, выученный (от learn)
learn	узнать, учиться
lease	аренда, сдавать в аренду
leash	поводок, цепь (не strap)
least	наименьший, менее всего
leather	кожа, кожаный
leave	оставлять, покидать, уезжать
leaving	уезжающий (от leave)
lecture	лекция
ledge	выступ, край
lee	защита 
left	покинутый, оставленный (от leave)
legacy	наследство
legally	законно
legal	законный
legend	легенда
legitimate	обоснованный
leg	нога
leisurely	не спеша
leisure	досуг
lemonade	лимонад
lemon	лимон
lend	дать в долг
length	длина
lens	линза
lent	одолжил, дал в долг (от lend)
lessen	уменьшать
lesson	урок
less	менее, в меньшей степени (от little)
letters	письма (от letter)
letter	письмо
Letting	разрешение
lettuce	салат
let	позволять, давать, разрешать
level	уровень
lever	рычаг
liable	подлежащий, обязанный, ответственный
liar	лгун
liberal	либеральный, щедрый; либерал
liberty	свобода
librarian	библиотекарь
libraries	библиотеки 
library	библиотека
licence	лицензия, разрешение (*****c*)
license	давать разрешение
lick	лизать
lid	крышка
lie	ложь, лгать, лежать
lifeboat	спасательная лодка
life	жизнь
lift	поднимать, подъемник, лифт
lighter	зажигалка
lighthouse	маяк
lighting	освещение
lightly	слегка (!NEW!)
lightning	молния
lights	фары (от light)
light	свет, освещение, фара, освещать, зажигать
liked	нравился, любил (от like)
likelihood	вероятность
likely	вероятно
likeness	сходство
likewise	так же (!NEW!)
like	любить, нравиться, похожий, подобный
lilac	сирень, сиреневый
lily	лилия
limbs	конечности (!NEW!)
limb	конечность (анат.)
lime	известь
limitation	ограничение
limited	ограниченный
limits	пределы 
limit	предел, граница
limp	хромота, прихрамывать
lined	выровненный 
linen	белье
line	линия, специальность
linger	медлить, задерживаться
lining	подкладка
link	соединять, соединить (link)
lion	лев
lip	губа
liquid	жидкость
liquor	крепкий спиртной напиток
listened	слушал (от listen)
listener	слушатель
listen	слушать
list	список
literal	буквальный
literary	литературный
literature	литература
litter	мусор, сорить
little	мало, маленький
lit	освещённый (!NEW!)
lived	жил, живший (от live)
lively	живой, оживленный
liver	печень
live	жить
living	средства к существованию, жизнь
lizard	ящерица
lizzie	автомобильчик 
loaded	загруженный
load	нагрузка, нагружать
loaf	безделье
loan	заём, ссуда
lobby	вестибюль
lobes	лепестки 
lobster	омар
local	местный
located	расположенный 
locate	определять местоположение (!NEW!)
locations	местоположения 
location	местоположение
locked	запертый
locking	захват
locksmith	слесарь
locks	замки 
lock	замок, запирать на замок
lodge	разместить
lodging	квартира, жилье
lofty	высокий, возвышенный
loft	сеновал, чердак
logic	логика
login	логин 
logs	бревна 
log	бревно
loneliness	одиночество (!NEW!)
lonely	одинокий
longer	длиннее (от long)
long	длинный, долгий, долго
looking	смотрящий (от look)
looks	выглядит (от like)
look	смотреть, выглядеть, взгляд, внешность
loom	принимать размеры
loop	петля
loosen	развязывать, распускать, ослаблять
loose	свободный
loot	ограбление
lord	лорд
lorry	грузовик (не truck)
lose	терять, проигрывать
losing	проигрыш, проигранный
loss	потеря, утрата
lost	потерял, проиграл, потерянный, проигранный (от lose)
Los	лос 
lots	уйма, куча, множество (не pile) (!NEW!)
lot	много
louder	громче
loudly	громко
loud	громкий
louisa	луиза 
louise	луиза 
loved	любил (от love)
lovely	прекрасный, восхитительный
lovers	любители(возлюбленные) 
lover	любитель, возлюбленный
love	любовь, любить
loving	любящий
lowered	пониженный 
lower	нижний, снижать, опускать
low	низкий
loyalty	верность
loyal	верный, лояльный
lucidly	понятно, ясно
lucius	лусиус 
luckily	к счастью
lucky	счастливый, удачный
luck	удача, везение
Lucy	люси 
luggage	багаж
Luke	лук 
lumber	лесоматериалы
lump	глыба, ком
luncheon	обед, лёгкая закуска
lunch	второй завтрак, обед
lustre	блеск, лоск, глянец, люстра
luxurious	роскошный
luxury	роскошь
lydia	лидия 
machinery	машины, механизмы
machine	машина
madame	мадам 
madam	госпожа
madeira	мадейра 
made	делал, сделанный (от make)
madly	безумно (!NEW!)
mad	обезумевший
magazines	журналы (от magazine)
magazine	журнал
magician	волшебник
magic	волшебный
magnificent	великолепный
maid	горничная
mail	почта, отправлять (по почте)
mainland	материк
mainly	главным образом
maintained	обслуженный(поддержанный) 
maintain	поддерживать
maintenance	поддержание
main	главный
majesty	величественность, величество (титул)
majority	большинство
major	специализироваться, главный
maker	производитель
makes	делает (от make)
make	делать, производить
making	создание, становление (процесс) (!NEW!)
male	мужчина, самец
malice	злоба
malicious	злобный
malignant	злобный, злостный, злокачественный
mallet	деревянный молоток
mallow	просвирник 
mama	мама 
mamma	мама 
management	управление
manager	управляющий
manages	ухитряется (от manage)
manage	справляться, ухитряться, управлять
mane	грива
mania	мания
manifest	явный, проявлять(ся)
manipulate	манипулировать
manipulation	манипуляция 
mankind	человечество
manners	способы (не methods) (!NEW!)
manner	способ, образ действия, манера
manoeuvre	маневр, маневрировать
mansfield	мансфилд 
mansion	дворец
mantle	покрывать, окутывать
manual	ручной
manufacture	производство, производить
manure	удобрение
manuscript	рукопись
many	много (с исчисляемыми существительными)
man	мужчина, человек
map	карта
marble	мрамор
marched	прошел 
March	маршировать
marco	марко 
margaret	маргарет 
margarita	маргарита 
margin	минимум, нижняя грань, предел
marianne	мэрианн 
Maria	мария 
mariner	моряк
marine	морской флот, морской
market	рынок
market	рынок
marks	оценки (от mark)
mark	норма, состояние, оценка, отметка
marmot	сурок
marquis	маркиз 
marriage	свадьба
married	женатый, замужняя
marrying	бракосочетание
marry	жениться, выходить замуж
marsh	болото
martial	военный
marvellous	удивительный, замечательный
marvel	удивляться, поражаться
mask	маска
mason	каменщик
masquerade	маскарад, маскироваться
masses	массы 
massive	массивный
mass	масса, множество
masterpiece	шедевр
master	хозяин (не hoster)
mast	мачта
matches	сделки, спички 
match	спичка, матч
materials	материалы 
material	материал
mate	товарищ
mathematical	математический
Maths	математика
matters	дела, материалы (от matter)
matter	дело, сущность, материал
mattress	матрац
mature	зрелый, созреть
maturity	зрелость
mat	коврик (не rug)
maud	дорожный плед 
maximum	максимум 
maxim	принцип
maybe	мoжет быть
mayor	мэр
May	май
meadow	луг
meals	еда (от meal)
meal	еда, есть, принимать пищу (не food)
meaningless	бессмысленный
meaning	значение
means	средство, способ
meantime	между тем
meant	означаемый, подразумеваемый (!NEW!)
meanwhile	тем временем, между тем
mean	означать
measles	корь
measured	измеренный 
measures	меры 
measure	мера
measuring	измерения (от measure)
meat	мясо, мясной
mechanical	механический
mechanics	механика
mechanic	механик
mechanism	устройство
medal	медаль
meddle	вмешиваться
medical	медицинский
medicine	медицина, лекарство
medieval	средневековый
meditate	размышлять, обдумывать
medium	средство, середина
meek	кроткий
meeting	встреча
meet	встречать(ся), знакомиться
meg	мэг 
melancholy	меланхолия 
melon	дыня
melt	таять
members	члены (от member)
member	член
memorable	памятный
memorandum	памятная записка
memory	память
menace	опасность (не danger)
mended	починил, починенный (от mend)
mend	чинить, ремонтировать
mentally	умственно
mental	умственный
mentioned	упомянул (от mention)
mention	благодарность, упоминать
menu	меню
men	мужчины (от man)
merchandise	торговля
merchant	торговец (не salesman)
merciful	милосердный (не gracious)
mercury	ртуть
mercy	милость
merely	единственно
mere	простой
merge	слиться 
merit	достоинство
merry	веселый, радостный
message	сообщение, поручение
messenger	посыльный, курьер
mess	беспорядок, путаница
metal	металл, металлический
meter	счетчик
method	метод
metropolitan	столичный
met	встречались, встреченный (от meet)
Mexican	мексиканец 
me	мне, меня
mice	мыши
microphone	микрофон
microscope	микроскоп
midday	полдень
middle	средний
midnight	полночь
midst	середина
mid	средний
mighty	могущественный
might	можно, возможно (от may)
mildred	милдред 
mild	мягкий (не soft)
miles	мили (от mile)
mile	миля
military	военный
milk	молоко
millet	просо, пшено
millions	миллионы 
million	миллион
mill	фабрика, завод, мельница
minded	склонный 
minds	ум (!NEW!)
mind	память, мнение, помнить, возражать
mineral	минeральный
mine	мой (употребляется без последующего существительного)
mingled	смешанный 
miniaturization	миниатюризация 
minims	мельчайшая частица, очень маленькая доля, капля 
minimum	минимум
mining	горный
minister	министр
ministry	министерство
minority	меньшинство
minor	младший, незначительный, второстепенный
mint	мята
minus	минус
minutes	минуты (от minute)
minute	минута
miracle	чудо
mirror	зеркало
mirth	веселье, радость
miscellaneous	смешанный, разнообразный
mischief	зло, беда
mischievous	злонамеренный, злобный, шаловливый, озорной
miserable	несчастный
misery	страдания, нищета
misfortune	несчастье
mishap	неудача (не unluck)
mislead	вводить в заблуждение
missing	недостающий, отсутствующий, пропавший (без вести)
missionary	миссионер
mission	миссия
miss	промах, промахнуться, пропустить, скучать
mistaken	ошибочный (от mistake)
mistake	ошибка
mistress	хозяйка, госпожа
misty	туманный
mist	дымка
mixture	микстура
mix	смешивать, мешать
mm	мм 
moaning	стенание
moan	оплакивать, стонать
mobile	подвижный
mob	толпа, сборище
mockery	издевательство
mock	насмехаться (не jeer)
model	модель
moderately	умеренно 
moderate	умеренный
modern	современный
modest	скромный
mode	способ
modification	модификация 
modified	видоизменённый (!NEW!)
modify	модифицировать
module	модуль 
moisture	влажность (не humidity)
moist	сырой, влажный
mole	крот
molly	молли 
momentary	мгновенный 
momentum	импульс
moment	момент, миг
monarch	монарх
Monday	понедельник
money	деньги
monkey	обезьяна
monks	монахи 
monotonous	однообразный, монотонный
monsieur	господин 
monsters	монстры 
monster	чудовище
monstrous	чудовищный
monthly	(еже)месячный, ежемесячно
months	месяцы (от month)
month	месяц
Monuments	памятники (от monument)
monument	памятник (не memorial)
mood	настроение
moonlight	лунный свет (!NEW!)
moon	луна
mop	швабра, подтирать
moral	нравственный
moreover	кроме того
more	еще, больше
morning	утро
morrow	завтра, завтрашний день; следующий день (!NEW!)
morsel	кусочек
mortal	смертный, смертельный (не lethal)
mortgage	заклад, залог
Morton	мортон 
Moscow	москва
mosquito	комар
mossy	мшистый
moss	мох
mostly	главным образом (не mainly)
most	самый, весьма
motel	мотель, гостиница
mother	мама
moth	моль, мотылек
motionless	неподвижный
motion	движение
motives	поводы 
motive	повод, мотив
motley	разноцветный, пестрый
motor	мотор
mould	плесень; плесенный грибок
mound	насыпь, холмик
mountain	гора
mount	взбираться
mournful	грустный
mourning	траур
mourn	сетовать
mouse	мышь
moustache	усы
mouth	рот
movements	движения 
movement	движение
move	двигать(ся), переезжать
movies	кино, фильмы (от movie)
movie	кино, фильм
moving	трогательный
mow	косить
Ms	госпожа 
much	много (с неисчисляемыми существительными)
muddy	грязный, мутный
mud	грязь
muffled	закутанный, укутанный, завёрнутый (не wrapped) (!NEW!)
muffler	шарф
muggy	теплый, влажный, удушливый
mug	кружка
mulberry	тутовое дерево 
mule	мул, тупица, гибрид, туфля без задников
multiple	многократный
multitude	множество
multi	много 
mumble	бормотание
mummy	мумия 
munch	чавкать
mural	стенная живопись, фреска
murderer	убийца
murder	убийство
murmur	шорох, шепот
muscles	мускулы 
muscle	мышца
muscular	мускулистый
museum	музей
musical	музыкальный, мюзикл
musician	музыкант
Music	музыка
must	должен, надо
mute	немой (не dumb)
mutiny	мятеж, поднять мятеж
muttered	бормотал 
muttering	бормотание
mutter	бормотать
mutton	баранина
mutual	взаимный, общий (не common)
muzzle	морда, намордник, дуло
myrtle	мирт 
myself	себя, меня самого, себе, сам
mysterious	таинственный
mystery	тайна
myth	миф
my	мой, моя, мое, мои
nab	курок
nails	ногти (от nail)
nail	ноготь, гвоздь
naive	наивный
naked	обнаженный, голый
namely	а именно
name	имя, фамилия, называть
nancy	нэнси 
nan	нэн 
napkin	салфетка, пеленка
napoleon	наполеон 
narrative	повествование, рассказ
narrow	узкий
nasty	скверный, плохой
national	национальный
nations	нации 
nation	нация, народ
natives	аборигены 
native	родной
naturalists	натуралисты 
naturalist	натуралист 
naturally	естественно
natural	естественный
nature	природа
Nat	нат 
naughty	непослушный
navigation	судоходство, плавание, навигация
navy	военный флот
nay	более того, даже; отрицательный ответ; отказ;
nearby	поблизости (nearby)
nearest	ближайший (от near)
nearly	почти, приблизительно (не almost)
near	близко от, около
neatly	аккуратно (!NEW!)
neat	чистый, опрятный
necessarily	обязательно
necessary	нужный, необходимый
necessity	необходимость
necklace	ожерелье
neck	шея
ned	нед 
needlework	шитье
needle	игла
need	нуждаться в, надо, нужда, потребность
negative	отрицательный, отрицание, негатив
neglected	пренебрег 
neglect	пренебрегать
negligence	небрежность
negotiate	договариваться
neighbourhood	соседство
neighbouring	соседний
neighbour	сосед
neither	также не
Nell	нелл 
nephew	племянник
nerves	нервы (от nerve)
nerve	нерв
nervous	нервный
nest	гнездо
network	сеть
net	сеть
neutral	нейтральный
nevertheless	тем не менее
never	никогда
newcomer	новичок (не beginner)
newly	вновь (не again)
newsletter	новости
newspapers	газеты (от newspaper)
newspaper	газета
news	новости, известия
new	новый
next	следующий, соседний, затем, потом
nicely	хорошо
nicer	лучше (от nice)
nicest	самый вкусный (от nice)
nice	хороший, чудесный, приятный
niche	ниша
nickel	никл (монета в 5 центов)
nickname	прозвище
nick	зарубка 
nieces	племянницы 
niece	племянница
nightingale	соловей
nightmare	кошмар
nights	ночи (от night)
night	ночь
nineteenth	девятнадцатый
nineteen	девятнадцать
ninety	девяносто
nine	девять
ninth	девятый
nip	укус, щипать, пересечь
nobleman	дворянин
nobles	знать (знатные люди) 
noble	благородный, знатный
nobody	никто
nodding	кивающий 
node	узел (не knot) 
nod	кивать головой, кивок
noiseless	бесшумный
noises	шумы 
noise	шум
noisy	шумный
none	нисколько, совсем не, вовсе не
nonsense	чепуха, ерунда
non	не
noon	полдень
normally	обычно
normal	нормальный
northern	северный
north	север
nor	и не, также не
nose	нос
nostrils	ноздри 
nostril	ноздря
notable	заметный
notably	исключительно
notebook	тетрадь
note	запись, записка, банкнота, записывать
nothing	ничто, ничего
notice	извещение, сообщение, замечать, обращать внимание
notify	извещать, уведомлять (не inform)
notions	понятия 
notion	понятие
notorious	известный, отъявленный
notwithstanding	несмотря на, тем не менее, однако
not	не
nourishing	питательный (
nourishment	питание, пища
novelty	новизна, новинка
novel	роман
November	ноябрь
nowadays	в наше время
nowhere	нигде, никуда
now	сейчас
no	нет, никакой
nuisance	досада
nulls	пустые указатели 
null	пустой указатель 
numbers	номера(числа) 
number	номер
numb	онемелый, оцепенелый (не dumb, )
numerals	числительные (от numeral)
numeric	числовой 
numerous	многочисленный
nursery	детский, ясли
nurse	няня (не nanny)
nurse	няня (не nanny)
nuts	орехи (от nut)
nut	орех
nylon	нейлон, нейлоновый
oak	дуб
oars	вёсла (!NEW!)
oar	весло
oath	клятва, присяга
obedience	послушание
obedient	послушный
obey	подчиняться, слушаться
objected	возразил (не retorted) 
objections	возражения (от objection)
objection	возражение, протест
objective	цель, стремление (
objects	объекты(цели) 
object	возражать, предмет
obligation	обязательство
obliged	обязан, признателен (от oblige)
oblige	обязывать
obscure	затемнять, затруднять понимание
observation	наблюдение, замечание
observed	наблюдаемый (!NEW!)
observer	наблюдатель
observe	наблюдать, замечать (не outlook)
obstacle	препятствие
obtained	полученный
obtain	добиваться
obviously	очевидно
obvious	очевидный
occasionally	изредка
occasional	случайный
occasioned	причиняемый 
occasion	случай, обстоятельство
occupation	занятие
occupied	занятый (!NEW!)
occupy	занимать, завоёвывать
occurrence	возникновение 
occurs	происходит 
occur	случаться
ocean	океан
October	октябрь
odds	разница, неравенство
odd	странный
odour	запах, аромат
offence	обида
offended	обиженный (!NEW!)
offend	обижать, обидеть
offensive	наступление
offering	предложение
offer	предлагать
officer	служащий, офицер
office	офис, контора
officially	официально
official	официальный, чиновник
offset	смещенный
offspring	потомство 
off	прочь, от
often	часто
of	предлог родительного падежа (кого?, чего?)
oh	O!
oil	масло
OK	все в порядке
oldest	старший, самый старый
old	старый
olive	олива, маслина; оливкового цвета
omelette	омлет
ominous	зловещий
omit	опускать, пропускать, упускать
once	один раз, однажды
oneself	(самого) себя
onion	лук
only	только, единственный
onto	на (не upon)
onward	вперед, далее, продвигающийся вперед
on	на, вперед, дальше
opened	открыл, открытый (от open)
opening	начало, открытие
openly	открыто
open	открывать
operate	действовать
operating	управляющий
operation	действие, операция
operative	действующий
operator	оператор
opera	опера
opinion	мнение
opponent	соперник
opportunity	возможность
opposed	противопоставленный 
opposite	противоположный
opposition	противодействие
oppressive	гнетущий, деспотический
optional	дополнительный 
options	выбора 
option	выбор
opt	выбирать
oranges	апельсины (от orange)
orange	апельсин, оранжевый
orchard	фруктовый сад
orchestra	партер, оркестр
ordered	приказал (от order)
orderly	аккуратный
order	порядок, приказ, заказ, заказывать, приказывать
ordinal	порядковый
ordinarily	обыкновенным, обычным путем; обычно; нормально; в обычной степени
ordinary	обычный, простой
organic	органический
organization	организация
organized	организовывал (от organize)
organizer	организатор
organize	организовывать
organs	органы 
organ	орган
oriental	восточный
originally	первоначально
original	оригинал, первоначальный
originate	возникать, происходить, давать начало, порождать; создавать
origin	происхождение
ornament	украшение, орнамент; украшать
orphan	сирота, сиротский
or	или
ostrich	страус
otherwise	иначе
other	другой
ought	долженствование
ourselves	себя, себе, сами
ours	наш
our	наш
outbreak	взрыв, вспышка, начало (войны и т.п.)
outcome	результат
outcry	крик, протест
outdoor	на открытом воздухе
outer	внешний
outfit	снаряжение, обмундирование, оборудование
outlaw	человек вне закона, изгнанник
outlet	выход, выходное отверстие
outline	контур, конспект, план, схема; краткое содержание
output	выпуск, продукция
outrage	нарушение закона, насилие, оскорблять
outright	открыто, прямо; без утайки (не straight, directly)
outside	снаружи, наружный
outskirts	окраина (города), опушка (леса)
outstanding	выдающийся
outward	внешний, наружный (не outside)
outwit	перехитрить
out	вне, вон, из, снаружи, наружный
oven	печь
overall	всеобщий
overcoat	пальто
overcome	преодолеть
overflow	переливаться через край, заливать, переполнять
overhead	наверху, над головой, верхний
overhear	подслушивать
overjoyed	вне себя от радости, очень довольный
overload	перегружать
overlook	надзирать
override	наехать, переехать; задавить отвергнуть 
overthrow	свергать
overtime	сверхурочные
overturn	опрокидывать(ся), ниспровергать
overwhelming	несметный
overwhelm	засыпать, забрасывать (вопросами), сокрушать
over	через, над, сверх
owen	оуэн 
owe	быть должным
owing	должный
owl	сова
ownership	собственность
owners	владельцы 
owner	владелец
own	иметь, владеть, свой, собственный
oxbow	ярмо
oxygen	кислород
ox	бык
oysters	устрицы (от oyster)
oyster	устрица
oz	унция 
pace	шагать
pacific	мирный
package	пакет
packet	пакет (не bundle)
pack	упаковывать, упаковать
paddle	короткое весло, грести одним веслом; шлепать по воде
padlock	висячий замок
pad	мягкая прокладка, подушка; подбивать (ватой и т.п.)
page	страница
paid	платил, оплаченный (от pay)
pail	ведро
painful	причиняющий боль, мучительный
pains	боли, страдания (от pain)
painter	художник
painting	живопись
paint	красить, краска
pain	боль, страдание
pairs	пары 
pair	пара
palace	дворец
pale	бледный
palm	ладонь
pal	приятель, товарищ, дружок
pamphlet	брошюра, памфлет
panel	комиссия
pane	оконное стекло
pang	острая боль
panic	паника
pantomime	пантомима 
pantry	кладовая, чулан (не closet)
pant	задыхаться (не gasp)
pan	сковорода
paper	бумага, газета
parade	парад
paragraph	параграф
parallel	параллельный
parameters	параметры 
parameter	параметр 
parcel	пакет
parchment	пергамент 
pardon	извинение
parents	родители (от parent)
parent	родитель, родственник
parked	припаркованный 
parking	стоянка
park	парк, (при)парковать(ся)
park	парк, (при)парковать(ся)
parliament	парламент
parlor	комната 
parlour	кабинет
parrots	попугаи 
parrot	попугай
parsley	петрушка (бот.)
parted	разделенный 
partially	частично 
partial	частичный
participate	участвовать
particles	частицы 
particularly	особенно, в особенности
particular	особый
parties	вечеринки (от party)
parting	прощание
partition	разделение
partly	частично
partner	участник
parts	части (от part)
party	вечеринка, группа
part	часть, доля, роль, делить, расставаться, расходиться
passages	проходы (!NEW!)
passage	проход
passed	прошел (от pass)
passengers	пассажиры 
passenger	пассажир
passing	прохождение
passionate	страстный
passion	страсть
passwords	пароли 
Password	пароль 
pass	передавать, проходить, пропуск, перевал
paste	тесто, клейстер, паста; клеить, склеивать
pasture	пастбище
past	после, за
patch	заплатка
pathetic	трогательный
paths	дорожки (не roads, lanes) 
path	тропинка, беговая дорожка
patience	терпение
patiently	терпеливо 
patient	пациент, терпеливый
patrol	патруль
patsy	паци 
patted	ласкал 
pattern	модель
pat	хлопок
Paul	пол (!NEW!)
pause	пауза
pausing	приостановка
pavement	тротуар (не sidewalk)
paws	лапы 
paw	лапа
paying	платеж
payment	плата
pay	платить, зарплата
peaceable	миролюбивый, мирный
peacefully	мирно
peaceful	мирный, спокойный
peace	мир
peaches	персики (от peach)
peach	персик
peacock	павлин
peak	вершина
peal	трезвон, раскат грома
peanut	земляной орех
Pearls	Жемчуг 
pearl	жемчуг, жемчужный
pears	груши (от pear)
pear	груша
peas	горошек, горох
pea	горох
pebble	галька, горный хрусталь
peck	клевать
peculiarities	особенности 
peculiar	особенный
pedal	педаль
pedestrian	пешеход
pedestrian	пешеход
peeks	(он) посмотрит
peel	чистить, почистить
peep	проблеск, выглядывать
peered	глядел
peering	глядя
peer	вглядываться, всматриваться
peeves	обиды 
peg	целиться
pencil	карандаш
pending	во время, в течение
penetrate	проникать внутрь
penholder	ручка (для пера)
penknife	перочинный нож
penny	пенни
pensioner	пенсионер
pen	ручка
people	люди
pepper	перец
perceived	воспринятый 
perceive	воспринимать, ощущать
percent	процент
percy	перси 
perfection	совершенство
perfectly	совершенно, вполне
perfect	совершенный
performance	спектакль
performed	выполненный (не от слова fulfil) 
perform	делать, выполнять
perfume	духи
perhaps	возможно, может быть
perilous	опасный, рискованный
peril	опасность
periodic	периодический
periods	периоды 
period	период
permanently	постоянно
permanent	постоянный
permissible	допустимый
permission	разрешение
permitted	разрешенный 
permit	разрешать
perpendicular	перпендикулярный
perpetual	вечный, постоянный
perry	перри 
persecution	преследование
perseverance	настойчивость, упорство
persian	персидский 
persistent	настойчивый
personally	лично
personal	личный
persons	люди 
person	человек, особа, лицо, личность
perspective	перспектива, перспективный
persuaded	убежденный (не convinced) 
persuade	убеждать
perverse	извращенный, испорченный, превратный
per	в
pest	паразит, вредитель, бич
peter	питер 
petition	петиция, прошение, подавать петицию
petrol	бензин
pets	домашние животные (от pet)
pet	любимое домашнее животное, любимец
phantom	фантом 
phase	фаза, фазировать
Philadelphia	филадельфия 
philip	филип 
philosophical	философский
philosophy	философия
phone	телефон
phosphate	фосфат 
photographer	фотограф
photographer	фотограф
photographic	фотографический
photographing	фотографирование
photography	фотография
photograph	фотография, фотографировать
photo	фотография
phrase	фраза
physically	физически
physical	физический
physician	врач
piano	пианино
picked	собранный, выбранный (!NEW!)
pickles	маринованные огурцы
pick	собирать, подбирать, выбирать
picnic	пикник
picturesque	живописный
pictures	картины (от picture)
picture	картина, изображение, рисовать, описывать
piece	кусок
pierce	пронзать, протыкать, пронизывать, проникать
pier	пристань, мол, свая, бык
pie	пирог
pigeons	голуби 
pigeon	голубь
pigs	свиньи 
pig	свинья
pike	щука (не lung)
piled	сложенный 
pile	куча, груда, кипа, пачка
pillar	колонна, столб
pillow	подушка
pills	таблетки (от pill)
pilot	пилот
pilot	пилот
pincers	клещи, щипцы
pinching	зажимание
pinch	щипать, прищемить, щипок
pineapple	ананас
pine	сосна
pink	розовый
pins	значки (от pin)
pin	булавка, значок, прикалывать
pious	набожный
pipe	труба (не tube)
pirate	пират
pistol	револьвер, пистолет
pitched	переданный 
pitcher	подающий
pitch	бросок, уровень, сооружать
piteous	жалкий, жалобный
pitiful	жалкий, ничтожный
pity	жалость
pit	яма, партер (не dig)
pizza	пицца
place	место
placing	размещение
plainly	явно (не clearly, obvious) 
plains	равнины 
plain	ясный, очевидный, равнина
planes	самолеты (от plane)
planets	планеты 
planet	планета
plane	самолет
plane	самолет
plank	доска
planned	плановый
planning	планирование
plans	планы (от plan)
plantation	плантация
plants	заводы(растения) 
plant	завод, растение, сажать, внедрять, посадить
plan	план, планировать
plaster	пластырь, штукатурка, штукатурить
plastic	пластмасса, пластичный
plates	тарелки (от plate)
plate	тарелка
plate	тарелка
platforms	платформы 
platform	платформа
played	играл (от play)
player	плейер, игрок
playing	играющий (от play)
plays	играет (от play)
playwright	драматург
play	играть, игра (play)
pleaded	умолял 
pleasantly	приятно (!NEW!)
pleasant	приятный
pleased	довольный
please	пожалуйста (только в просьбе)
pleasure	удовольствие
plenty	изобилие, избыток, вполне, довольно
plot	заговор
plough	пахать
plucky	смелый, отважный (не manful)
pluck	ощипывать, выщипывать, рвать (цветы)
plug	пробка (не cork)
plumage	оперение 
plume	перо
plump	пухлый, полный (не swell)
plums	сливы (от plum)
plum	слива
plunder	добыча, грабить
plunged	погруженный 
plunge	нырять
plural	множественное число (грам.)
plus	плюс
pockets	карманы (!NEW!)
pocket	карман
pod	стручок, лущить
poems	стихи (от poem)
poem	стихотворение, поэма
poetry	поэзия, стихи
poet	поэт
pointed	острый, многозначительный, совершенно очевидный
pointing	указывающий (
points	пункты(точки) 
point	точка, пункт, суть дела, указывать, показывать
poisonous	ядовитый
poison	яд, отравлять
poke	толчок, тыкать
poking	тыкание
polar	полярный
pole	полюс
policeman	полицейский
police	полиция
policy	политика
Polish	лак
politely	вежливо (!NEW!)
politeness	вежливость 
polite	любезный, вежливый
political	политический
politics	политика
pollen	пыльца 
poll	подсчет (голосов), голосование; голосовать, подсчитывать голоса
pompey	помпей 
pond	пруд (не pool)
pony	пони
pool	пруд, бассейн
poorly	плохо, неважно
poor	бедный
popped	совавший 
popular	популярный
population	население, жители
pop	поп, популярный
porcelain	фарфор
porch	крыльцо, (амер.) веранда, терраса
pore	пора
pork	свинина
porridge	каша
portable	переносной
ported	перенесенный, транспортированный 
porter	носильщик
portions	части
portion	часть, доля (не section, segment)
portrait	портрет
ports	порты (от port)
port	порт
pose	поза, ставить (вопрос, задачу)
position	положение
positively	положительно 
positive	положительный
possessed	хладнокровный, владеющий собой, одержимый (!NEW!)
possession	владение
possess	обладать
possibility	возможность
possible	возможный
possibly	возможно
postage	почтовые расходы
postal	почтовый
postcard	почтовая открытка
poster	плакат
postman	почтальон
postman	почтальон
postpone	отсрочивать
post	почта, после
potatoes	картофель (от potato)
potato	картофель
potentially	потенциально
potential	потенциал, потенциальный
potions	микстуры 
potion	микстура 
pots	горшки 
potter	гончар 
pot	котелок
poultry	домашняя птица
pounce	налетать
pounds	фунты (от pound)
pound	фунт, фунт стерлингов
poured	лил 
pour	лить
poverty	бедность
powder	пудра
powerfully	сильно
powerful	могущественный, сильный
powers	полномочия 
power	держава, энергия, сила, мощность (не force)
practicable	осуществимый
practically	практический
practical	практический
practiced	применял, практиковал (от practice)
practice	практика
practise	заниматься
praised	хвалил (от praise)
praise	хвалить
prank	проделка, разряжаться
prayers	просьбы(просители) 
prayer	молитва, просьба
pray	молить
preach	проповедовать
precarious	ненадежный
precaution	предосторожность
preceding	предшествующий
precious	драгоценный
precisely	точно
precise	точный
precision	точность
predator	хищник
predicate	сказуемое (грам.)
prediction	предсказание
preference	предпочтение
preferred	предпочитал (от prefer)
prefer	предпочитать
prefix	(грам.) префикс, приставка
pregnant	беременная, чреватый (последствиями и т. п.)
preliminary	предварительный (не preparatory)
preparations	приготовления 
preparation	приготовление
prepared	готовился, готовый (от prepare)
prepare	готовить(ся)
preparing	подготовка 
preponderant	преобладающий
prescription	рецепт
presence	присутствие
presented	представленный 
presentiment	предчувствие
presently	вскоре
Presents	подарки (от present)
present	настоящее время, подарок, настоящий, присутствующий
preservation	сохранение, сохранность, консервирование
preserved	сохраненный 
preserve	сохранять
president	президент
pressed	поглаженный, сжатый (от press)
pressing	срочный, настойчивый
pressure	давление
press	(по)гладить, сжимать, нажимать, печать, пресса
presumably	возможно
presume	предполагать (не suppose)
pretence	притворство
pretend	притворяться, делать вид
pretty	хороший, значительный
prevailed	преобладал 
prevail	торжествовать (не triumph)
prevented	предотвращенный 
prevent	предотвращать, препятствовать
preview	предварительный просмотр
previously	предварительно
previous	предшествующий
prey	жертва
pre	пред 
priceless	бесценный
price	цена
prickly	колючий
prick	(у)колоть(ся)
pride	гордость
priest	священник
primary	первичный
prime	главный (не chief, major)
princess	принцесса 
prince	принц
principal	главный, основной, важнейший
principles	принципы 
principle	принцип
printing	печатание
print	печатать, напечатать
priority	приоритет
prior	прежний
prisoners	заключенные 
prisoner	заключенный
prison	тюрьма
privacy	уединенность
privately	конфиденциально
private	частный
privileged	привилегированный
privilege	привилегия
prize	приз
probability	вероятность
probable	вероятный (
probably	вероятно (
problems	проблемы (от problem)
problem	проблема
procedures	процедуры 
procedure	процедура
proceedings	труды, записки
proceeding	поступок, мероприятие, протоколы, записки
proceed	продолжать
processes	процессы 
procession	процессия
process	процесс
proclamation	воззвание, прокламация
procurator	поверенный 
procured	обеспеченный (не provided, supplied) 
procure	доставать, добывать
produced	производил (от produce)
producer	режиссер
produces	производит 
produce	производить
producing	создание
productions	производство 
production	производство
product	продукция
professional	профессиональный
profession	профессия
professor	профессор
profitable	прибыльный, выгодный, полезный
profit	прибыль
profound	глубокий
programmes	программы, передачи (от programme)
programme	программа
programming	программирование
programs	программы (от program)
program	программа
progress	прогресс, успех
prohibited	запрещенный (от prohibit)
projects	проекты (от project)
project	проект
prolong	продлевать
prominent	выдающийся
promised	обещал (от promise)
promise	обещать
promising	многообещающий
promotion	поощрение
promptly	быстро
prompt	проворный, быстрый
prone	склонный
pronounced	явный 
pronounce	произносить
pronunciation	произношение
proof	доказательство
properly	правильно, должным образом
property	собственность, имущество
proper	правильный
prophet	пророк
proportion	пропорция
proposal	предложение
proposed	предложенный 
propose	предлагать (не suggest)
proposition	предложение
prop	подпорка, опора, подпирать
prospects	перспективы 
prospect	перспектива
prosperity	процветание, благосостояние
prosperous	преуспевающий
prosper	процветать
protected	защищенный 
protection	защита
protective	защитный
protect	защищать, предохранять
protest	протестовать, протест
protocol	протокол 
proudly	гордо
proud	гордый
proved	доказанный 
prove	доказывать, доказать
provided	при условии
providence	провидение
provide	обеспечивать
provisions	условия (не conditions) 
provision	заготовка
provocative	вызывающий, провокационный
provoke	вызывать, провоцировать
prudent	осторожный, благоразумный (не careful)
pry	любопытный человек
psychology	психология
publication	публикация
publicity	гласность
publicly	публично
public	общественный (не social)
published	публиковал, опубликованный (от publish)
publish	публиковать
pub	трактир, гостиница
pudding	пудинг
puddle	лужица, смущать, барахтаться в воде
puff	дымок, дуновение (ветра); дымить, попыхивать
pug	мопс, моська, курносый нос
pullover	пуловер
pull	тянуть, тащить
pulp	мякоть, бумажная масса
pulse	пульс, пульсировать
pumpkin	тыква
pump	насос
punch	пробивать (отверстия), ударять кулаком, удар кулаком, пунш
punctual	пунктуальный, аккуратный
punishment	наказание
punish	наказывать, наказать
pun	каламбур
pupil	ученик
purchaser	покупатель
purchase	покупка, покупать
pure	чистый
purge	чистка (не clean)
purple	лиловый, малиновый
purposes	цели 
purpose	цель
purse	кошелек
pursued	преследуемый 
pursue	преследование
pursuing	преследование
pursuit	преследование, погоня, занятие
pushed	вытолкнутый (!NEW!)
pushing	подталкивание(выдвижение)
push	толкать
put	класть, размещать
puzzled	озадачен, поставлен в тупик (от puzzle)
puzzle	приводить в затруднение, загадка
pyjamas	пижама
pyramid	пирамида
qualify	квалифицировать
qualities	качества 
quality	качество
quantity	количество
quarrel	ссора, ссориться
quarter	четверть, квартал
quay	набережная
queen	королева
queer	странный, эксцентричный
quench	утолять (жажду)
query	вопрос, спрашивать
questionable	сомнительный
questions	вопросы (от question)
question	вопрос
quest	поиски
quicker	быстрее (от quick)
quickly	быстро
quick	быстрый
quietly	тихо, спокойно
quiet	тихий, спокойный
quill	катушка
quite	вполне, совсем
quit	прекращать
quivering	дрожащий (не от слов tremble, shiver)
quiver	дрожать, трепетать; дрожь; трепет
quiz	опрос, проверять знания
quotation	цитата
quoted	указанный 
quote	цитировать
rabbits	кролики 
rabbit	кролик
races	гонки(расы) 
race	раса, гонка
racing	гоночный (
racket	ракетка
rack	полка для багажа над сиденьем
radiant	лучистый, сияющий, лучезарный
radiator	радиатор
radioactive	радиоактивный
radio	радио
raft	плот (!NEW!)
rage	гнев, ярость (не fury)
ragged	истрепанный, оборванный, рваный
rag	тряпка, лохмотья
raid	нападение
railing	ограда, перила
railroad	железная дорога
railway	железная дорога
rail	рельс
rainbow	радуга
raincoat	плащ
rainy	дождливый
rain	дождь
raised	рельефный
raise	поднимать, возвышать
raising	воспитание
rake	грабли, сгребать
ralph	ральф 
ram	баран
ranch	ранчо
random	случайный, беспорядочный
ranger	скиталец
range	ряд, линия, диапазон
rang	звонил (!NEW!)
rank	ряд, чин, выстраивать
ransom	выкуп, выкупать
ran	бежал, убежавший (от run)
rapidly	быстро
rapid	быстрый
rapture	восторг, восхищение (не delight)
rapt	восхищенный, похищенный
rarely	редко
rare	редкий, недожаренный
rash	стремительный, поспешный, опрометчивый; сыпь
raspberry	малина
rates	стоит (от rate)
rate	тариф, расценка, степень, оценивать
rather	скорее, лучше
rational	рациональный
rattle	трещать, греметь, грохотать; треск, грохот, погремушка, трещотка
rat	крыса
raw	сырой
ray	луч
razor	бритва
reach	достигать
reaction	реакция
react	реагировать
reader	читатель
readily	охотно
readiness	находчивость
reading	чтение
ready	готовый
read	читать
realistic	реалистический
reality	действительность
realize	представлять себе, реализовать
really	на самом деле, действительно
realm	царство 
reared	воздвигнутый 
rear	задняя часть
reasonable	разумный
reasonably	разумно
reasoning	рассуждение
reason	причина, довод, разум, рассудок
reassure	заверять
rebellion	восстание, бунт
rebellious	мятежный, бунтарский
rebuff	неудача, отпор
recalled	отозванный 
recall	припомнить, отозвать
receipt	квитанция
receiver	приемник
receive	получать
receiving	получение
recently	недавно
recent	недавний
reception	прием
recipe	рецепт
recite	рассказывать, перечислять
reckless	отчаянный, безрассудный, опрометчивый
reckon	считать
recognition	узнавание
recognize	узнавать, узнать
recoil	отдача, отпрянуть, испытывать ужас
recollection	воспоминание (не reminiscence)
recollect	припоминать
recommended	рекомендуемый 
recommend	рекомендовать
reconnaissance	разведка
reconstruct	реконструировать
recorded	зарегистрированный 
recorder	записывающее устройство
recording	регистрация
records	пластинки (от record)
record	запись, пластинка, отчет, рекорд
recovery	выздоровление
recover	выздоравливать
recreate	заново создавать, воскрешать, освежиться 
recruit	вербовать, нанимать
redeem	выкупать, искупать, выполнять (обещание и т.п.)
reduced	уменьшенный (не lowered) 
reduce	уменьшать, понижать, сокращать
reducing	понижает (от reduce)
reduction	снижение
red	красный
reeds	тростники (не canes) 
reed	тростник, камыш (не cane)
reel	катушка, барабан (тех.); пошатываться, спотыкаться (не coil)
references	рекомендации (от reference)
reference	рекомендация, ссылка, справка
referred	отнесенный 
refers	обращается(относится) 
refer	отсылать, ссылаться
reflected	отраженный 
reflecting	отражающий
reflections	отражения 
reflection	отражение, размышление
reflect	отражать, размышлять
reform	улучшать, реформа
refrain	удерживать, сдерживать, воздерживаться
refreshments	закуски и напитки
refreshment	подкрепление
refresh	освежать
refrigerator	холодильник
refuge	убежище
refusal	отказ
refused	отказался (от refuse)
refuse	отказывать
regain	достичь
regarded	расцененный 
regarding	относительно
regardless	независимо от
regards	привет, поклон
regard	взгляд, внимание, смотреть, считать
regiment	полк
regions	области(регионы) 
region	район, область
registered	зарегистрированный, заказной (от register)
register	(за)регистрировать
registration	регистрация
registry	регистрация(регистратура) 
regret	жалеть
regularly	регулярно
regular	регулярный
regulate	регулировать, приспосабливать
rehearsal	репетиция
reign	царить, господствовать
reins	поводья, вожжи
rejection	отказ
reject	отвергать
rejoice	радовать(ся)
rejoined	воссоединенный 
relate	относиться, связывать
relationship	родственные связи
relations	отношения, связи (от relation)
relation	отношение, связь
relative	родственник
relax	ослаблять
relay	смена (не shift)
released	освобожденный
release	освобождение, освобождать
reliable	надежный
reliance	доверие, уверенность
relic	след, остаток, пережиток
relief	облегчение, утешение
relieved	избавленный (!NEW!)
relieve	облегчать
religion	религия
religious	религиозный
relish	вкус, привкус, смаковать
reluctantly	неохотно (не unwillingly)
reluctant	делающий что-либо с большой неохотой, по принуждению; сопротивляющийся
rely	полагаться, доверять
remainder	остаток
remained	оставшийся (!NEW!)
remains	остается 
remain	оставаться
remarkable	замечательный
remarkably	замечательно
remarks	замечания
remark	замечать, замечание (не notice)
remedy	лекарство
remembered	помнил (от remember)
remember	помнить
remembrance	воспоминание, память
remind	напоминать, напомнить
remiss	небрежный, вялый
remote	дистанционный, удаленный
removal	перемещение
removed	удалённый (!NEW!)
remove	удалять, убирать, перемещать
renamed	переименованный 
rendered	предоставленный (не supplied) 
render	отдавать
renewal	обновление (не refresh)
renewed	возобновленный (не resumed) 
renew	обновлять
renting	аренда, снятие комнаты
rent	брать напрокат, снимать жилье, квартирная плата
reopen	возобновлять (не resume)
repaired	ремонтировал, отремонтированный (от repair)
repair	ремонтировать, ремонт, починка
repay	оплачивать
repeatedly	неоднократно
repeat	твердить, говорить наизусть
repel	отталкивать, внушать отвращение
repentance	раскаяние
repent	раскаиваться
repetition	повторение
replacement	замещение
replace	заменять, замещать
reply	отвечать, ответ
reporter	репортер
reporter	репортер
reporting	сообщение
report	доклад, сообщать, рассказывать
repose	полагаться, доверяться
representation	изображение
representative	представитель
represent	изображать, представлять
reproach	упрек, осуждение, упрекать
reproduce	воспроизводить
reproof	порицание, выговор (не reprove)
reprove	порицать, делать выговор
reptile	пресмыкающееся
republic	республика
repulse	отражать (врага), отвергать, отталкивать, отпор
reputation	репутация
requested	требуемый 
requests	просьбы (от request)
request	просьба
required	потребованный (не demanded) (!NEW!)
requirement	требование
requires	требует 
require	требовать
rescue	спасение, спасать
research	исследование
resemblance	сходство
resemble	походить
resentment	возмущение
resent	обижаться, возмущаться
reservation	предварительный заказ, резервирование
reserved	заказал, заказанный (от reserve)
reserve	заказывать
reservoir	резервуар
residence	резиденция
residential	жилой
resident	постоянный житель
reside	жить, проживать
resignation	отставка, заявление об отставке, покорность, смирение
resigned	покорный, безропотный
resign	уходить в отставку
resistance	сопротивление
resist	сопротивляться
resolution	решение, резолюция, решимость
resolved	решился, принял решение (!NEW!)
resolve	решать
resort	обращение, обращаться
resources	ресурсы 
resource	ресурс, средство
respectable	почтенный, порядочный
respected	уважаемый 
respectful	почтительный
respectively	соответственно
respective	соответственный
respect	уважение, уважать
responded	отвечал 
respond	отвечать
response	реакция, ответ (не reaction)
responsibility	ответственность
responsible	ответственный
responsive	отзывчивый
restart	переначало 
restaurant	ресторан
rested	отдыхал (от rest)
restless	беспокойный, неугомонный
restoration	реставрация
restore	восстанавливать
restrain	сдерживать
restrictions	ограничения (от restriction)
restriction	ограничение
restrict	ограничивать
rest	остальное, остальные, остаток
result	результат
resumed	возобновленный 
resume	итог, сводка, возобновлять, подводить итог
retained	сохраненный 
retain	удерживать
retired	отставной
retirement	отставка
retire	уходить, удаляться, оставлять должность
retiring	скромный
retorted	парировал 
retreat	отступать, отступление, убежище
return	вернуть(ся), возвращение
revealed	показанный 
reveal	обнаруживать
revenge	месть, мстить
revenue	доход
reverence	почтение, благоговение (не deference)
reverse	противоположное, обратное
reversion	возвращение (не returning) 
revert	возвращаться (не return)
review	обзор, смотр (не survey)
revision	пересмотр
revive	оживать
revolutionary	революционный, революционер
revolution	революция
revolve	вращаться
rev	оборот
reward	награда
rex	рекс 
rhinoceros	носорог
rhyme	рифма, рифмовать
rhythm	ритм
ribbon	лента
rib	ребро (не hip)
rice	рис
Richard	ричард 
riches	богатство, изобилие
rich	богатый
rick	стог, складывать в стог
riddle	загадка (не enigma)
rider	наездник, всадник
ride	езда, прогулка (не пешая), ехать (на поезде, велосипеде и т.п.)
ridge	горный хребет, гребень (горы и т.п.) (не crest)
ridiculous	нелепый, смехотворный, смешной
riding	еду (от ride), верховая езда
rid	освобождать
rifle	ружье, винтовка
rift	трещина, щель, ущелье
rightly	справедливо
right	правильный, правый
rigid	жесткий (не tough)
rigorous	суровый (не severely)
rig	снаряжение, экипаж
rim	ободок
rind	кожура, кора, корка (не pool)
rings	кольца 
ring	кольцо, звон, звонок, звенеть, звонить
ripen	зреть, созревать
ripe	спелый
rip	рвать
risen	повышенный 
rise	подниматься, восходить, подъем, повышение
rising	возрастающий
risk	риск, рисковать
rival	соперник, соперничающий
rivers	реки 
river	река
rivulet	ручеек, речушка
road	дорога
roam	бродить, скитаться
roar	реветь, орать, хохотать
roast	жареный
robbery	грабеж
robber	грабитель
robes	одежды 
robin	малиновка
robot	робот 
rob	грабить, обворовывать
rocky	скалистый (!NEW!)
rock	скала
rode	ехать (2 форма) (!NEW!)
rod	прут, жезл, удочка
rogue	плут, мошенник (не valet)
role	роль
rollback	обратная перемотка 
roller	ролик
roll	вращение, список, булочка, вращаться, катить(ся)
romance	романтика, романтическая история
romantic	романтичный
Roman	католик 
Rome	рим 
ron	рон 
roof	крыша
rooms	комнаты (от room)
room	комната
root	корень
ropes	веревки 
rope	канат
rose	роза
rosy	розовый, румяный (не pink)
rotten	гнилой, отвратительный
rot	вздор, нелепость
rouge	румяна, губная помада
rough	грубый
rounded	округленный 
round	круг, цикл, полный, круглый
roused	разбуженный (не awoken) 
rouse	будить, побуждать (первая буква не a)
route	маршрут, путь, направлять
rover	скиталец, странник
rowing	гребля, выговор
row	грести
royal	королевский (не queen)
RPM	оборот в минуту 
rubber	резина
rubbing	протирка (не от слова wash)
rubbish	ерунда, мусор (не garbage)
ruby	рубиновый
rub	тереть, стирать, трение
rudder	руль
rude	грубый, резкий, невоспитанный
rudimentary	Элементарный(рудиментарный) 
rueful	унылый
ruffle	ерошить (волосы), рябить (воду)
rug	ковер
ruins	руины 
ruin	гибель
ruler	линейка, правитель
rules	правила (от rule)
rule	правило, принцип, норма, управлять, решать
ruling	правящий (
rumour	слух, молва
rum	ром, странный
rung	ступенька, спица колеса
runners	бегуны 
runner	бегун
running	пробег, бегущий
runs	пробега 
run	бегать, двигаться, бег, движение, направление
ruse	уловка, хитрость
rush	устремляться, бросаться, мчаться
Russian	русский
Russia	россия
rustle	шелест, шорох, шелестеть, шуршать
rusty	заржавленный, порыжевший
rust	ржавчина, ржаветь
ruth	жалость, сочувствие, участие, сострадание
rut	колея, привычка
rye	рожь
sabotage	саботаж, саботировать
sack	мешок
sacred	священный
sacrifice	жертва
saddle	седло, седлать
sadly	печально
sadness	печаль
sad	печальный
safeguard	гарантия
safety	безопасность
safe	сейф, безопасный, надежный
said	сказал (от say)
sailor	матрос
sail	парус, плыть
saint	святой
sake	ради, для
salad	салат, винегрет
salary	оклад
sale	распродажа
sally	поездка, прогулка
salmon	лосось
salts	соли 
salt	соль, соленый, солить
salute	приветствовать, салют
salvage	спасать (!NEW!)
salvation	спасение
same	тот же, так(ой) же
sample	образец
Sam	сэм 
sanction	санкция
sandwiches	бутерброды 
sandwich	бутерброд
sandy	песчаный
sand	песок
sanguine	живой, жизнерадостный, румяный (не spirited)
sang	пел, спел (от sing)
sank	тонул (!NEW!)
sap	сок (растений); подрывать
satisfaction	удовлетворение
satisfactorily	удовлетворительно
satisfactory	удовлетворительный
satisfy	удовлетворять
Saturday	суббота
sat	сидел (от sit)
saucepan	кастрюля
saucepan	кастрюля
saucer	блюдце
sauce	соус, приправа, поливать соусом
sausage	колбаса, сосиска
savagely	свирепо, дико
savage	дикарь
saved	спасал (от save)
save	спасать, хранить, экономить
saving	экономия
saviour	спаситель
savoury	вкусный, пикантный, приятный
saw	видел, смотрел (от see)
saying	говорящий (от say)
say	сказать, говорить
scaffold	эшафот
scale	масштаб
scan	просмотр 
scarcely	едва
scarce	редкий, едва (не barely, merely, hardly)
scared	напуганный (!NEW!)
scare	испуг
scarf	шарф
scarlet	алый
scar	шрам, рубец
scattered	разбросанный, раскиданный 
scatter	разбрасывать, рассеивать
scenery	декорации
scenes	сцены, эпизоды (от scene)
scene	действие, картина, сцена
scent	запах, духи, след, почуять, нюхать (не smell)
schedule	расписание, таблица, планировать
schemes	схемы 
scheme	проект
scholars	ученые 
scholar	ученый
schoolboy	школьник
schoolmaster	учитель
school	школа, обучать
Science	наука, умение
scientific	научный
scientist	ученый
scissors	ножницы
scold	бранить, ругать
scope	пределы
score	счет, отметка, выигрывать
scornful	презрительный
scorn	презрение, презирать
Scotch	надрез, метка, уничтожать
scoundrel	негодяй
scout	разведчик
scowled	Хмурился (не от слова frown) 
scrambled	боролся(взбирался) 
scramble	карабкаться
scrap	клочок, кусочек, отрывок
scratched	поцарапанный 
scratch	царапать
scream	вскрикнуть, зареветь, визг, вопль (не shriek)
screen	экран, перегородка, прикрывать
screw	привинчивать, завинчивать, принуждать, винт
scribble	каракули, писать неразборчиво
scripts	подлинники(сценарии) 
script	сценарий
scrub	тереть
scuba	акваланг 
scuffle	драка, потасовка
sculpture	скульптура
seal	печать, запечатывать
seaman	моряк
seam	шов
search	искать, обыскивать, поиск, обыск
seasick	страдающий морской болезнью
seaside	морское побережье
season	время года, сезон, созревать
seated	помещенный 
seats	места (от seat)
seat	место, сиденье, сажать, усаживать
seaweed	морская водоросль 
sea	море, океан
secondary	средний, второстепенный
secondly	во-вторых
second	второй, помощник, секунда
secretary	секретарь
secretion	укрывательство 
secret	секрет
section	отделение, делить на части
secure	страховать
security	безопасность
sedate	спокойный
seedlings	рассада 
seedling	рассада 
seeds	семена 
seed	семя, семена
seeing	видящий (от see)
seek	искать (не find)
seeming	видимый, мнимый (не visible)
seem	казаться
seen	увиденный (от see)
see	(у)видеть, встретиться
segment	доля (не portion, section) 
seized	захваченный (!NEW!)
seize	хватать
seldom	редко
selected	отобранный 
selection	отбор
select	выбирать, сортировать, избранный
selfish	эгоистичный
self	сам, себя
seller	торговец (не trader)
selling	продажа
sell	продавать, торговать
semicolon	точка с запятой
semi	полу 
send	отправлять, посылать
senior	старший
sensation	чувство
senses	чувства 
sense	чувство, здравый смысл, чувствовать
sensible	разумный
sensitiveness	чувствительность 
sensitive	чувствительный
sentence	предложение
sentiments	чувства 
sentiment	настроение
sent	отправил, послал, отправленный, посланный (от send)
separated	отделенный 
separate	отдельный
separation	отделение, разделение
September	сентябрь
sequel	продолжение, результат
sequence	последовательность
sergeant	сержант
series	серия
seriously	серьезно
serious	серьезный
sermon	проповедь
serpent	змея, змей
servant	слуга
servers	прислуга 
server	прислуга 
serve	служить, обслуживать, подавать
services	услуги 
service	сервис, обслуживание
serving	порция
session	заседание (не sitting)
sets	декорации (от set)
setting	окружение
settlement	поселение
settle	поселять, устраивать, оплачивать
set	класть, ставить, помещать, комплект
seventeen	семнадцать
seventh	седьмой
seventy	семьдесят
seven	семь
several	несколько
severely	строго
severe	суровый, жестокий
sew	шить
sexual	сексуальный
sex	пол
shabby	потрепанный, поношенный
shades	оттенки (от shade)
shade	оттенок, тень, затенять
shadow	тень, покров, заслонять
shady	тенистый, сомнительный, темный
shaft	древко, ручка, рукоятка, вал (тех.)
shaggy	лохматый
shake	пожать (руки), дрожать, трясти
shallow	мелкий, поверхностный, (от)мель
shall	модальный глагол долженствования
shame	стыд, стыдить, стыдиться
sham	притворство, обман
shaped	форменный 
shapeless	бесформенный
shape	форма
share	разделять, доля, часть
shark	акула
sharpen	точить
sharply	резко
sharp	точно, ровно, резкий, крутой, плутовать
shave	(по)бриться, бритье, подстригать
shaving	бритье (
shawl	платок, шаль
shed	сарай
sheep	овца, овцы
sheer	настоящий
sheet	простыня, лист, пласт
shelf	полка
shells	снаряды(раковины) 
shell	раковина, скорлупа
shelter	приют, убежище
shelves	полки 
shepherd	пастух
sheriff	шериф 
she	она
shield	щит
shift	смена, перемещать
shilling	шиллинг
shindy	шум, скандал
shine	сиять, светить
shiny	солнечный (не sunny) 
shipwreck	кораблекрушение
ship	корабль, пароход, грузить, перевозить
shirt	рубашка, блузка
shiver	дрожать, дрожь, трепет
shocking	потрясающий
shock	удар
shoemaker	сапожник
shoes	обувь, туфли (от shoe)
shoe	ботинок, туфля
shone	сиял, блестел (!NEW!)
shook	трёс (!NEW!)
shooting	стрельба 
shoot	стрелять, застрелить
shopping	делать покупки
shops	магазины (от shop)
shop	магазин, мастерская
shore	берег
shorter	короче (от short)
shortest	ближайший, самый короткий (от short)
shorthand	стенография
shortly	вскоре
shorts	трусики
short	короткий, слабый, внезапно
shot	попытка, выстрел
shoulder	плечо, толкать
should	следует (от shall)
shout	кричать, крик
Shoved	пихал (не popped) 
shovel	лопата
shove	толкать(ся), пихать, толчок
showed	показал (от show)
shower	душ, ливень
shown	показанным 
show	показывать, демонстрировать, выставка, зрелище
shrewd	проницательный, ловкий (делец)
shriek	кричать, вскрикнуть, пронзительный крик (не scream)
shrill	резкий, пронзительный
shrimp	креветка
shrine	сохранять
shrink	отпрянуть, садиться (о материи)
shrubs	кусты (не bushes) (!NEW!)
shrub	куст
Shrugged	пожал 
shrug	пожимать плечами
shudder	дрожь, вздрагивать; содрогаться
shuffle	шаркать
shutdown	закрытие 
shutter	ставень, затвор
shut	закрывать, запирать, замолчать
shy	застенчивый, робкий
sibilant	шипящий звук
sickly	болезненный, нездоровый, тошнотворный
sickness	болезнь, заболевание
sick	больной
sidenote	заметка на полях 
sideways	боком, косвенно
side	сторона, бок, край
sierra	горная цепь
sieve	решето, сито
sights	достопримечательности
sight	зрелище, вид, заметить, разглядеть
sigh	вздыхать, вздох
signal	сигнал, сигнализировать
signature	подпись
signed	подписанный 
significance	значение
significantly	значительно
significant	значительный
signify	значить, означать, иметь значение
signs	знаки, вывески (от sign)
sign	подписывать(ся), знак, вывеска
silence	молчание, тишина
silent	молчаливый, бесшумный
silk	шелковый, шелк
silly	глупый
sill	подоконник
silver	серебро, серебряный
similarly	также
similar	похожий
simple	простой, однозначный
simplicity	простота (
simply	просто, абсолютно
simulator	симулянт
simultaneously	одновременно
simultaneous	одновременный
sincerely	искренне (не earnestly) 
sincere	искренний (
since	с тех пор как
singing	пение 
single	один, одинокий
singular	странный, необычный, единственное число (грам.)
sing	пение, петь
sinister	зловещий
sinking	погружение
sink	тонуть
sink	тонуть
sin	грех, (со)грешить
sire	родитель 
sir	сэр
sister	сестра
site	местоположение
sitting	заседание
situated	расположенный
situation	положение
Sit	сидеть, заседать, годиться
Sixpence	сумма в 6 пенсов
sixteen	шестнадцать
sixth	шестой
sixty	шестьдесят
six	шесть
size	размер, величина, измерить
skeleton	скелет, остов
sketch	эскиз
skiing	катание на лыжах
skilful	квалифицированный, умелый, ловкий
skilled	квалифицированный, умелый, ловкий
skill	мастерство
skim	просматривать, скользить
skinner	погонщик (!NEW!)
skinny	худой, тощий, кожа да кости (!NEW!)
skins	кожи 
skin	кожа
skip	пропускать (часто бывает при устано (!NEW!)
skirt	юбка
ski	ходить на лыжах
skull	череп
sky	небо
slab	плита
slacken	ослаблять, ослабевать
slack	ленивый, слабый, ослаблять, утихать
slammed	Хлопнул 
slam	хлопать, хлопнуть
slang	жаргон
slant	наклонный
slap	хлопать
slaughter	резня, убой, резать, убивать
slaves	рабы (!NEW!)
slave	раб
sledge	ехать на санях
sleek	гладкий, приглаживать
sleepy	сонный, сонливый (не asleep)
sleep	спать, сон
sleeve	рукав
sleigh	сани, салазки
slender	тонкий, стройный
slept	спал (от sleep)
slice	ломоть
slide	скользить
slid	скользить (не slip) (!NEW!)
slightest	малейший (от slight)
slightly	слегка
slight	проявление пренебрежительного равнодушия;неуважение, пренебрежение, игнорирование
slime	слизь, липкая грязь, ил; комбинация (белье)
slim	стройный
slippery	скользкий
slip	скольжение, скользить
slogan	лозунг
slope	склон, наклон, гора для катания
slower	медленнее (от slow)
slowly	медленно
slow	медленный, замедлять
slumber	сон, дремота, дремать
sly	хитрый
smack	рыболовное судно
smallest	самый маленький 
small	маленький, тонкий, скромный
smartly	ловко
smart	изящный (не grace)
smashed	разбитый 
smashing	сокрушительный,разящий (дословный перевод) (переносный:замечательный, великолепный, потрясающий)
smash	бить, разбивать
smear	масляное пятно, пачкать, мазать
smell	запах
smelt	плавить
smiles	улыбки 
smile	улыбаться, улыбка
smoked	курил (от smoke)
smoker	курящий, вагон для курящих
smoke	курить, курение, дым
smoking	курение
smoothly	гладко (!NEW!)
smooth	гладкий
snack	закуска, часть, доля
snake	змея
snapped	сфотографированный 
snap	щелкать (snap)
snare	ловушка
snarl	рычать, огрызаться; рычание, ворчание
snatch	схватить
sneer	усмешка, насмешка; насмехаться, издеваться
sneeze	чихать, чиханье
sniffed	фыркал 
sniffing	фыркающий 
sniff	фыркать, сопеть
snigger	хихикать, хихиканье
snoop	подсматривать (!NEW!)
snore	храпеть, храп
snorted	фыркал (не от слова sniff) 
snowman	снежная баба
snow	снег, падать (о снеге)
snuff	нюхнуть 
soap	мыло
sobbing	рыдание 
sober	трезвый
sob	рыдание
sociable	общительный
social	общественный
society	общество
socket	патрон (эл. лампочки), глазная впадина
socks	носки (от sock)
sock	носок
sofa	диван
softened	смягченный 
soften	смягчать(ся)
softly	мягко, нежно
software	программное обеспечение 
soft	мягкий, тихий (не calm)
soil	почва
solder	паять
soldier	солдат
sold	продавал, проданный (от sell)
solely	исключительно 
solemnly	торжественно
solemn	серьезный, торжественный
sole	подошва, подметка; ставить подметку
solid	твердый
solitary	одинокий, уединенный
solitude	одиночество, уединение
solution	решение, разрешение
solve	(раз)решать
somehow	как-нибудь, так или иначе
sometimes	иногда
somewhat	что-то, отчасти
somewhere	где-нибудь
some	немного, несколько
song	песня
sons	сыновья (от son)
son	сын
sooner	охотнее (от soon)
soon	скоро, рано
soothe	успокаивать, утешать, облегчать (боль)
soothing	успокаивающий
soot	сажа
sophisticated	сложный
sore	больной, воспаленный (не sick)
sorrowful	печальный, скорбный
sorrow	печаль
sorry	сожалеющий, печальный, унылый
sorting	сортировка 
sort	сорт, род, вид, сортировать
sought	искавший(разысканный) 
souls	души 
soul	душа, воплощение
sounding	звучащий
sounds	звучит (от sound)
sound	звук, звучать, играть
soup	суп
source	источник
sour	раздражительный, сердитый, кислый
southern	южный
south	юг
souvenirs	сувениры (от souvenir)
souvenir	сувенир
sovereign	суверенный
soviet	советский 
sow	сеять
so	так, таким образом, итак
space	пространство, место, космос
spacious	просторный, обширный
spade	лопата, заступ
spared	сэкономленный 
spare	уделять, лишний, запасный
sparkler	бриллиант 
sparkle	сверкать, искриться
spark	искра
sparrow	воробей
spasmodic	судорожный
spat	размолвка, звонкий удар
speaker	оратор
speaking	говоря(щий) (от speak)
speaks	говорит 
speak	говорить, убеждать
spear	дротик, копье
specialist	специалист
speciality	фирменное блюдо
specialize	специализировать
specially	особенно
special	специальный, особенный
species	порода
specifically	специфически
specification	спецификация 
specific	специфический
specified	указанный 
specify	точно определять, устанавливать, предписывать; детально излагать
specimens	Экземпляры, образцы 
specimen	образец
spectacles	очки
spectacle	зрелище
spectacular	производящий глубокое впечатление; впечатляющий; эффектный
speculation	размышление
speechless	безмолвный
speech	речь
speedily	быстро
speedometer	спидометр
speedy	быстрый, скорый
speed	скорость, ускорять, спешить
spelling	орфография, правописание
spell	писать или произносить (слово) по буквам
spends	проводит (время) (от spend)
spend	тратить
spent	проводил, тратил, проведенный, потраченный (от spend)
sphere	сфера
spiders	пауки 
spider	паук
spike	острие (!NEW!)
spill	проливать(ся), рассыпать(ся)
spine	позвоночный столб
spin	прясть, крутить(ся)
spirited	живой, бойкий
spirits	души (!NEW!)
spirit	дух
spiteful	злобный
spite	злость
spit	плеваться, фыркать
splash	брызгать(ся), забрызгать, плескать(ся); плеск, брызги
splendid	замечательно
splinter	щепка, осколок, заноза
split	раскалывать
spoil	портить, баловать
spoken	сказанный (!NEW!)
spoke	говорил, говоривший (от speak)
sponsorship	попечительство
spoons	ложки (от spoon)
spoon	ложка
spoon	ложка
sporting	спортивный (
sportsman	спортсмен
sports	спорт, спортивные соревнования (от sport)
sport	спорт, заниматься спортом
spotless	безупречный
spots	пятна(места) 
spotted	определенный
spot	пятно
spout	носик (посуды), желоб
sprang	прыгал (от слова spring) 
spray	брызги, обрызгивать
spreading	распространение
spread	распространяться
spree	веселье, шалость
spring	весна
sprout	пускать ростки; отросток, побег
spruce	ель 
sprung	прыгал (от слова spring) 
spurt	бить струей, делать внезапное усилие
spur	стимул
spy	шпион, шпионить
squadron	эскадрон, эскадра (мор.)
squad	команда
squall	писк, визг
square	площадь, квадратный
squeal	визг
squeezed	сжатый 
squeeze	выжимать, сжимать, давить, впихивать, сжатие, давка
squint	косоглазие, косить (о глазах)
squirrel	белка
stability	устойчивость
stable	конюшня
stack	стог, куча, груда
stadium	стадион
stadium	стадион
staff	штат, персонал, штаб
stage	сцена, эстрада, ставить
Staggered	пораженный
stagger	шатание, шатать
stain	пятно, пятнать, пачкать
staircase	лестница
stair	лестница
stake	ставка, делать ставку
stale	черствый, затхлый
stalk	стебель
stalls	кресла в партере ( от stall)
stall	партер
stammer	заикаться, запинаться
stamps	марки (от stamp)
stamp	марка, печать, штемпелевать
standard	стандарт
standing	репутация, вес, положение в обществе, стоящий (
standstill	застой (не stagnation)
stand	остановка, позиция, стенд, киоск, стоять, останавливаться
stared	пристальный (!NEW!)
stare	пристальный взгляд
starling	скворец
starter	стартер
startle	испугать, сильно удивить
starts	запуски 
start	начинать, отправляться
starve	умирать от голода
star	звезда
stated	зафиксированный, высказанный, изложенный заявленный 
stately	величавый, величественный
statements	утверждения(заявления) 
statement	утверждение, заявление
statesman	государственный деятель
states	государства 
state	государство, состояние
stationery	писчебумажные принадлежности
station	станция, место, размещать
statistics	статистика
statue	статуя, памятник
stature	рост
status	статус
statute	закон, устав
stayed	остался (от stay)
staying	остающийся, живущий (от stay)
stay	оставаться, жить (временно)
St	C
steadily	неуклонно
steady	прочный
steak	бифштекс
stealing	кража 
steal	(с)воровать
steam	пар
steel	сталь
steep	крутой (не sharp)
steer	править (рулём)
stems	стебли 
stem	стержень
stepfather	отчим
stephen	стивен 
step	шаг, шагать (step)
sterile	бесплодный (!NEW!)
sterility	бесплодие 
sternly	строго (!NEW!)
stern	строгий
Steve	стив 
stew	тушеное мясо
sticking	торчащий, приклеенный (
Sticks	палки 
sticky	липкий, клейкий
stick	палка, приставать
stiffen	(о)коченеть, (о)деревенеть
stiff	негнущийся, застывший, холодный, натянутый
still	все еще, однако, тихий
stir	суета, суматоха, мешать, помешивать, волновать
stitch	стежок, петля (в вязании), шить
stockings	чулки (от stocking)
stocking	чулок
stocks	акции(запасы) 
stocky	коренастый, низкий, приземистый (!NEW!)
stock	запас, снабжать (не spare, hoard)
stolen	украденный (от steal)
stomach	живот, желудок
stone	камень
stool	табуретка
stooped	наклоненный 
stoop	наклонять(ся), нагибать(ся), сутулиться, горбиться
stoppage	остановка, задержка
stopped	остановились (от stop)
stopper	пробка, затычка
stops	остановки (от stop)
stop	остановка, перестать, остановиться
storage	хранение
stored	запасенный 
storey	этаж
store	магазин, имущество, запасать, снабжать
stories	истории, рассказы (от story)
stork	аист
stormy	бурный
storm	буря, взрыв (не blast)
story	рассказ, история
stout	тучный, дородный
stove	печь, плита
straightened	выправляемый 
straighten	выпрямлять(ся)
straightforward	прямой
straight	прямо, сразу, прямой, достоверный
strain	натягивать, напрягать(ся), напряжение
strait	узкий, пролив, затруднительное материальное положение, нужда
strangely	странным образом
strangers	незнакомцы 
stranger	незнакомец, иностранец
strange	странный
strangle	задушить
strap	ремень, стягивать ремнем
strategy	стратегия
strawberries	клубника
strawberry	земляника
straw	пустяк, мелочь
stray	сбиваться с пути, заблудившийся
stream	ручей, поток
street	улица
street	улица
strengthen	усиливать, укреплять
strength	численность, сила, прочность
stretched	растянутый (!NEW!)
stretching	протяжение 
stretch	растягивать, вытягиваться
strictly	строго
strict	точный
strike	ударять, забастовка
striking	бьющий, ударяющий (от strike)
strings	вереницы(нити) (не threads) 
string	вереница, ряд, струна, связывать
striped	полосатый
stripes	полосы 
strip	полоса
strode	походка, большой шаг (прошедшее время) (!NEW!)
stroke	удар, гладить
stroll	прогулка, гулять
strongest	самый сильный 
stronghold	крепость, оплот
strongly	решительно (первая буква не "d")
strong	сильный
struck	забастовка, удар (прошедшее время) (!NEW!)
structure	структура
struggle	бороться, борьба
struggling	борьба 
stubborn	упрямый
stuck	воткнул, приклеил (!NEW!)
students	студенты (от student)
student	студент
studied	учился (от study)
studious	прилежный
studio	студия
studying	занимается (от study)
study	учиться, изучать, заниматься, исследование, кабинет
stud	запонка
stuffed	наполненный 
stuffy	душный
stuff	вещество, материал, заполнять, набивать
stumbled	наткнулся 
stump	пень
stun	оглушать
stupid	глупый
style	стиль, фасон, прическа
subdued	подавленный
subjected	подвергнутый
subjects	предметы (от subject)
subject	предмет, содержание, подчинять
submarine	подводная лодка
submit	подчиняться
subqueries	подвопросы 
subquery	подвопрос 
subscriber	подписчик
subscribe	подписываться
subscription	подписка
subsequently	впоследствии
subsequent	последующий (не successive)
subsided	спадал 
substance	вещество
substantial	существенный, заметный, прочный, крепкий
substitute	заместитель
subtle	тонкий, неуловимый
suburb	пригород, окраина
succeeding	следование
succeed	достигать цели
successes	успехи (от success)
successfully	успешно
successful	удачный, успешный
succession	последовательность
successive	последующий
successor	преемник
success	успех, удача
such	такой
suck	сосать
suddenly	внезапно, вдруг
sudden	внезапный
sue	преследовать судебным порядком, возбуждать дело в суде
suffering	страдание
suffer	страдать
sufficiently	достаточно
sufficient	достаточный
suffix	суффикс (грам.)
suffocate	душить, задыхаться
sugar	сахар
suggested	предлагал, предложенный (от suggest)
suggestions	предложения (от suggestion)
suggestion	предложение
suggest	предлагать, советовать
suicide	самоубийство, самоубийца
suitable	подходящий, соответствующий (не eligible)
suitcases	чемоданы (от suitcase)
suitcase	чемодан
suited	удовлетворенный 
suite	номер люкс
suit	костюм, подходить, устраивать
sulky	мрачный, хмурый **l**
sulphur	сера
sultry	знойный, душный
summary	конспект, суммарный
summer	лето, летний
summit	вершина
summoned	вызванный 
summon	вызывать
sum	сумма, подводить итог
Sunday	воскресенье
sunflower	подсолнух
sunk	погруженным 
sunlight	солнечный свет
sunny	солнечный
sunrise	восход солнца
sunset	закат
sunshine	солнечный свет
sunstroke	солнечный удар
sun	солнце
superb	превосходный (не pretty)
superficial	поверхностный, внешний
superfluous	излишний, чрезмерный
superintendent	управляющий, заведующий
superintend	надзирать (за)
superiority	старшинство
superior	высший, лучший
superlative	превосходная степень (грам.)
supermarket	супермаркет
superserver	суперприслуга 
superstition	суеверие, предрассудки
supper	ужин
supplement	добавление
supplied	снабженный 
supplies	запасы(поставки) 
supply	снабжать
supported	поддержанный 
supporter	сторонник
supporting	опорный
support	поддерживать, опора, поддержка
supposedly	предположительно
supposed	предполагаемый (от suppose)
suppose	полагать, предполагать
suppressed	подавленный 
suppress	подавлять
supreme	верховный, высший
surely	несомненно
sure	уверенный, убедиться, безусловно
surfaces	поверхности 
surface	поверхность
surgeon	хирург
surgery	хирургия, приемная хирурга
surly	угрюмый, неприветливый **r**
surname	фамилия
surplus	излишек
surprise	удивление, удивлять
surprisingly	удивительно
surprising	удивительный
surroundings	окрестности, среда, окружение
surrounding	окружение 
surround	окружать
surveyed	рассмотренный 
surveying	рассмотрение
survey	осмотр
survive	пережить
suspected	подозреваемый 
suspect	подозревать
suspended	приостановленный (!NEW!)
suspend	приостанавливать
suspense	неизвестность
suspension	приостановка, пауза, перерыв
suspicions	подозрения 
suspicion	подозрение
suspicious	подозрительный
sustain	поддерживать
swallow	глотать, проглатывать
swamp	болото, топь
swam	плавал (от swim)
swan	лебедь
swarm	рой, толпа; роиться, толпиться (не crowd)
sway	качание, взмах
swear	клясться
sweater	эксплуататор
sweat	пот, потеть
sweep	(под)мести
sweetheart	возлюбленный(ая), дорогой(ая) (как обращение)
sweetness	сладость 
sweet	милый, сладкий, приятный
swelling	воспаление, отек
swell	отличный, превосходный
swept	подметал (!NEW!)
swiftly	быстро (!NEW!)
swift	быстрый (не speed)
swig	потягивать вино
swimmer	пловец
swimming	плавание
swim	плавать
swindle	обман, обманывать, надувать (не deceive)
swing	качание, качели, качаться, колебаться
switch	переключать, включать, выключатель, выключать
sword	меч, шпага, сабля
syllable	слог
symbol	символ
sympathetic	сочувственный
sympathize	сочувствовать
sympathy	симпатия, сострадание
syntax	синтаксис 
syringe	шприц
systems	системы 
system	система
tables	столы 
tablets	таблетки (от tablet)
table	стол, таблица, расписание
tab	петелька
tackle	хватать
tack	линия, курс
tactics	тактика
tag	бирка, ярлык
tail	конец, хвост
take	брать, взять, принимать
taking	овладение
talented	талантливый
talent	талант
tales	сказки, истории (от tale)
tale	повесть, сказка, история
talking	беседа
talk	говорить, беседовать
tally	бирка, этикетка, дубликат, копия (не label)
tall	невероятный, высокий
tame	приручать, приручить, прирученный
tangerine	мандарин (плод)
tangible	осязаемый
tangle	сплетение, путаница, запутывать(ся)
tank	танк, резервуар
tape	лента, обматывать лентой
tap	постучать
tap	постучать
target	задание
tar	смола, деготь; мазать дегтем, смолить
task	задача
tasted	пробовал (от taste)
tastes	имеет вкус (от taste)
taste	пробовать, иметь вкус
taught	обучал, обученный (от teach)
taxi	такси
taxi	такси
tax	налог
teacher	учитель
teaching	обучение
teach	обучать, преподавать
teams	команды (от team)
team	команда
tearing	разрывание
tears	слёзы (!NEW!)
tear	слеза, разрыв, (по)рвать
tease	дразнить, задира
tea	чай, отвар
technical	технический
technician	специалист
technique	техника
teddy	тэдди 
tedious	скучный, утомительный **d****
Ted	раскидывать
teenagers	подростки (от teenager)
teeth	зубы
telegram	телеграмма
telegraph	телеграф
telephone	телефон, звонить по телефону
telephone	телефон, звонить по телефону
telescope	телескоп
television	телевидение
tells	сообщает 
tell	говорить, рассказывать
temperature	температура
temper	сдержанность, самообладание
temple	храм
temple	храм
temporarily	временно
temporary	временный
temptation	искушение, соблазн
tempted	соблазненный 
tempt	искушать
tenant	арендатор, жилец
tendency	тенденция
tenderly	нежно, мягко (!NEW!)
tenderness	нежность (!NEW!)
tender	нежный
tend	иметь тенденцию
tennis	теннис
tense	время (грам.)
tentacles	щупальца 
tentative	предварительный, предполагаемый; умозрительный, не вполне определенный
tenth	десятый
tent	палатка
ten	десять
terminal	конечный пункт
terminate	кончать(ся)
terminus	конечная остановка 
terms	личные отношения, условия соглашения
term	семестр, срок
terrace	терраса
terrible	ужасный, страшный
terribly	ужасно
terrific	потрясающий, ужасающий
terrified	испуганный 
territory	территория
terror	ужас
testing	испытание
test	анализ, проверка, испытывать
textbook	учебник
text	текст
thankful	благодарный
thanks	спасибо
thank	благодарить
than	чем
that	это, тот, та, то
thaw	оттепель
theatres	театры (от theatre)
theatre	театр
thee	вас 
theft	кража
their	их (на вопрос "чей?")
theme	тема (не topic)
themselves	себя, себе
them	их (на вопрос "кого?", "что?")
thence	отсюда 
then	тогда, потом, затем
theory	теория
thereafter	после этого; впоследствии (не afterwards) (!NEW!)
thereby	таким образом
therefore	поэтому, следовательно
thereupon	после чего, на что
there	там, туда, вот
these	эти, это
they	они
the	определенный артикль
thicket	чаща 
thick	толстый, густой
thief	вор
thimble	наперсток, наконечник
things	вещи, дела (от thing)
thing	вещь, предмет
thinking	размышление
thinks	думает (от think)
think	думать, мыслить
thin	тонкий, худощавый
third	третий
thirsty	испытывающий жажду
thirst	жажда
thirteenth	тринадцатый
thirteen	тринадцать
thirty	тридцать
this	этот, это
Thomas	томас 
thong	ремень, плеть
thorny	колючий, тернистый ****n*
thorn	шип, колючка (не prick)
thoroughfare	проход, проезд
thoroughly	тщательно
thorough	тщательный
those	тот, та, то, те
thoughtfully	внимательно (!NEW!)
thoughtful	задумчивый, погруженный в размышления
thoughtless	необдуманный, беспечный, эгоистичный
thought	думал, обдуманный (от think), мысль
though	хотя, несмотря на
thousand	тысяча
thou	вы 
thrash	молотить, бить
thread	нитка
threatened	находящийся в угрожаемом положении (!NEW!)
threatening	угроза
threaten	грозить, угрожать
threat	угроза
three	три
threshold	порог
threw	бросал (не flung) (!NEW!)
thrice	трижды
thrilled	возбуждённый (!NEW!)
thrilling	захватывающий
thrill	волновать
thrive	преуспевать; буйно, пышно расти
throat	горло
throbbing	пульсация, биение
throb	пульсация, пульсировать
throne	трон
throng	толпиться, переполнять
throughout	повсюду, везде, во всех отношениях (не everywhere)
through	через, сквозь
throw	бросать
thrust	толчок, удар, толкать
thumb	большой палец (руки)
thunder	гром, греметь
Thursday	четверг
thus	так, таким образом
thy	ваш 
tickets	билеты (от ticket)
ticket	билет
tickle	щекотать
tide	прилив и отлив
tidying	уборка
tidy	чистый, аккуратный, убирать, приводить в порядок
tied	связанный (!NEW!)
ties	связи (от tie)
tie	связь, связывать, галстук
tiger	тигр
tighten	сжимать (не squeeze)
tight	плотный, крепкий, тугой
tile	черепица, кафель
till	до
Timeout	перерыв 
times	раз (от time)
timetable	расписание
time	время
timid	робкий, застенчивый
tim	тим 
tinker	ремесленник 
tinkle	звон, звяканье
tiny	крошечный
tin	олово, жестянка, консервная банка
tips	наконечники(чаевые) 
tiptoe	кончики пальцев, цыпочки
tip	чаевые, давать на "чай", наконечник
tired	усталый (от tire)
tiresome	утомительный
tire	уставать, надоесть
tiring	утомительный
title	заглавие, титул
toad	жаба
toast	тост (жар. хлеб), сушить
tobacco	табак
today's	сегодняшний (от today)
today	сегодня, теперь, современный
toddle	ковыляние, прогуливаться
toes	пальцы ноги(носки) 
toe	палец
toffee	ириска
together	вместе, одновременно
toilet	туалет
toil	трудиться, (тяжелый) труд
token	признак, примета
told	рассказал, сообщил (от tell)
tolerable	сносный, допустимый
tolerant	терпимый (не bearable)
tolerate	терпеть
tomatoes	помидоры (от tomato)
tomato	томат, помидор
tomb	могила, гробница
tome	том 
tommy	томми 
tomorrow	завтра, назавтра
tone	стиль, характер
tongs	щипцы, клещи
tongue	язык
tonight	сегодня вечером
ton	тонна
took	брал (от take)
tools	инструменты (!NEW!)
tool	инструмент
toothache	зубная боль
tooth	зуб
too	слишком, тоже
topic	тема
topmost	самый верхний, самый важный
topple	валиться
top	верх, верхушка
Torches	фонарики (!NEW!)
torch	факел
tore	рвал (!NEW!)
torn	оборванный (не worn) (!NEW!)
torrent	поток
tortoise	черепаха
torture	пытать, пытка (не attempt)
toss	толчок, сотрясение, кидать, бросать
totally	полностью
total	сумма, весь, полный
touching	трогательный
touch	соприкосновение, контакт
tough	жесткий
tourist	турист(ский)
tournament	турнир
tour	путешествие, тур (не trip)
towards	к, в направлении
toward	к, на
towel	полотенце
towers	башни 
tower	башня
towns	города 
town	город (не city)
tow	буксировать, тянуть, тащить
toys	игрушки (от toy)
toy	игрушка, играть, забавляться
to	предлог, частица инфинитива
traced	прослеженный 
traces	следы 
trace	следить, чертить
tracks	следы 
track	след, тропа, колея
trade	торговать, ремесло, занятие, профессия
trading	торговля
traditionally	традиционно
traditional	традиционный
traffic	уличное движение
tragedy	трагедия
tragic	трагический
trailer	прицеп к автомобилю
trail	след (не trace)
trained	обученный
trainer	тренер
training	тренировка, обучение
trains	поезда (от train)
train	поезд, привлекать, воспитывать
train	поезд, привлекать, воспитывать
traitor	изменник, предатель
tramp	бродить, громко топать, бродяга
tram	трамвай
tram	трамвай
tranquilizer	транквилизатор 
transactions	сделки 
transaction	дело, сделка, ведение (дел), труды, протоколы (общества)
transfer	передача, переносить
transformation	преобразование
translate	переводить, объяснять
translating	перевести (от translate)
translation	перевод
transmission	передача
transmitted	переданный 
transparent	прозрачный
transportation	перевозка
transport	транспорт, перевозить
trapdoor	люк
trapes	западни
trap	ловушка, западня
travelled	путешествовал, много путешествовавший (от travel)
traveller	путешественник
travelling	путешествие, путешествующий
travels	путешествия 
travel	путешествовать
traverse	пересекать
tray	поднос
treacherous	предательский, вероломный
tread	ступать, наступать
treasurer	казначей 
treasures	сокровища 
treasure	сокровище
treasury	сокровищница
treated	лечил (от treat)
treatment	обращение, обработка
treat	удовольствие, лечить, относиться
tree	дерево (tree)
trek	поход, переход (не pass)
tremble	дрожать, дрожь
tremendous	громадный, значительный
trend	общее направление, тенденция
trespass	преступать, нарушать границу (владения)
trials	испытания(суды) 
trial	попытка, испытание
tribe	племя, клан
tribute	дань
trice	мгновение
trick	хитрость, обман, обманывать
tried	пытался (от try)
trifle	пустяк
trifling	пустяковый
triggers	спусковые механизмы 
trigger	курок
trim	подрезка, стрижка
triple	тройной
trips	поездки (от trip)
trip	поездка, экскурсия
triumphal	триумфальный
triumphant	торжествующий, победоносный
triumph	триумф
trolley	тележка
troops	войска
troop	войска
trophy	трофей
tropical	тропический
trot	рысь, рысца, бежать рысью
troubled	побеспокоил (от trouble)
troublesome	трудный, неприятный, капризный (о ребенке)
troubles	неприятности (от trouble)
trouble	неприятность, беда, беспокоить(ся), волноваться
trousers	брюки
trout	форель
truck	грузовик
truck	грузовик
true	правильный, верный
truly	точно, правдиво, истинно, верно
trumpet	труба
trunk	ствол, туловище
trusted	доверял 
trust	доверять, доверие, вера
truthful	правдивый
truth	правда, истина
trying	ищу (место, адрес) (от to try for)
try	пробовать, пытаться
tube	труба (не pipe)
tub	кадка, лохань, ушат
tucked	подвернутый 
Tuesday	вторник
tumbled	кувыркался 
tumbler	тумблер 
tumble	падать, опрокидываться
tune	мотив
tunnel	тоннель
turf	дерн
turkey	индейка
Turk	турок 
turner	токарь
turnip	репа
turnstile	турникет 
turn	поворачивать, вращать, оборот, поворот, очередь
turpentine	скипидар
turtle	черепаха 
TV	телевизор, телевидение
twelfth	двенадцатый
twelve	двенадцать
twentieth	двадцатый
twenty	двадцать
twice	дважды, вдвое
twig	веточка, прутик
twilight	сумерки
twinkle	мерцать, сверкать, мигать, мелькать
twins	близнецы
twin	двойной, двойник, близнец
twisted	искривленный
twist	вить(ся), крутить, скручивать
twit	упрек, насмешка (не mock)
two	два
Types	типы 
typewriter	пишущая машинка
type	тип, род
typical	типичный
tyre	шина
T	бревно
ugly	уродливый
ultimately	в конечном счете 
ultimate	последний
umbrella	зонт
unable	неспособный
unanimously	единодушно
unanimous	единодушный, единогласный
unaware	незнающий
uncertain	неясный (не от слова clear)
unchanged	неизменившийся
uncle	дядя
uncomfortable	неудобный
uncommon	неординарный
unconscious	бессознательный
undergone	подвергнемся 
undergo	испытывать, подвергаться
underground	метрополитен, подземный, подпольный
underground	метрополитен, подземный, подпольный
underline	подчеркивать
underneath	вниз, внизу, под
understanding	понимание, способность понять
understand	понимать, подразумевать
understood	понимал, понятый (от understand)
undertake	предпринимать
undertaking	предприятие
underwater	под водой 
underwear	нижнее белье
under	под
undesirable	нежелательный
undoubtedly	несомненно
undo	развязывать, расстегивать
undress	раздеваться
uneasiness	тревога, неловкость
uneasy	встревоженный, неловкий
unexpected	неожиданный
unfair	несправедливый
unfinished	незаконченный
unfit	негодный, неподходящий
unfortunately	к несчастью, к сожалению
unfortunate	несчастный человек, горемыка
ungrateful	неблагодарный
unhappy	несчастный, неудачный (unhappy)
uniform	форма, форменная одежда
unions	союзы (от union)
union	союз
unique	уникальный 
united	объединенный
unite	соединять(ся)
units	единицы (от unit)
unity	единство
unit	единица
universal	всеобщий
universe	мир, вселенная
university	университет
unkind	недобрый
unknown	неизвестный
unleash	развязывать (войну)
unless	если не, пока не
unlikely	маловероятный, вряд ли
unlike	непохожий
unlimited	неограниченный (не boundless)
unload	разгружать(ся), разряжать (оружие)
unlock	отпирать
unlucky	неудачный
unmoved	равнодушный
unnatural	неестественный, противоестественный
unnecessary	ненужный
unofficial	неофициальный
unpleasant	неприятный
unpredictable	непредсказуемый
Unreal	нереальный
unreasonable	неразумный, неблагоразумный
unregistered	незарегистрированный 
unresolved	нерешенный
unrest	беспокойство (не bother, harass)
unseen	невидимый 
unskilled	неквалифицированный
unsuccessful	неудачный
untidy	неаккуратный
until	до
unusually	необычно
unusual	необычный
unwelcome	нежеланный, неприятный
unwilling	несклонный, нерасположенный
unwise	неразумный
unworthy	недостойный
un	оон 
updated	обновленный 
update	модернизация 
upgrade	модернизировать 
upon	на
upper	верхний
upright	прямой, вертикальный, честный, справедливый
uproar	шум, волнение (не shindy)
upset	беспорядок, расстройство, расстроенный
upstairs	наверху
upwards	вверх
upward	направленный вверх
up	вверх, до предела, наверху
urban	городской
urged	побуждённый, подстёгнутый 
urgently	срочно
urgent	крайне необходимый, срочный
urge	понуждать
urn	урна
usage	употребление, обычай
used	использованный, подержанный (от use)
usefully	с пользой
useful	полезный
useless	бесполезный
users	пользователи 
user	потребитель
use	использовать, употребить, польза, применение
using	пользование
usually	обычно, обыкновенно
usual	обыкновенный, обычный
us	нас, нам
utilities	предприятия коммунального обслуживания 
utility	полезность, выгодность, удобства, коммунальные услуги
utilize	использовать
utmost	крайний
uttered	произнесенный 
utterly	совершенно (не perfect, totally)
utter	издавать (звук), произносить
vacant	свободный, незанятый
vacation	отпуск, каникулы
vaccination	прививка
vaguely	неопределенно 
vague	неопределенный, смутный
vain	напрасный, тщетный
vale	прощание
valiant	храбрый, мужественный (не от слова brave)
valid	правильный
valleys	долины 
valley	долина
valuable	ценный, дорогой
valuation	оценка
valued	оцененный 
valuer	оценщик
values	ценности 
value	ценность, цена, дорожить, ценить
valve	клапан, створка, радио электронная лампа
vanished	исчез 
vanish	исчезать, пропадать
vanity	тщеславие
van	фургон, багажный вагон
van	фургон, багажный вагон
vapour	пар, пары
variability	изменчивость 
variables	переменные 
variable	изменчивый, непостоянный
variations	изменения(разновидности) 
variation	изменение(разновидность) 
varied	различный (не differ) 
varieties	множества 
variety	разнообразие
various	различный, разный
varnish	лак, лоск, лакировать
varying	изменение
vary	отличаться, расходиться
vase	ваза
vastly	значительно
vast	обширный, громадный
vault	свод
veal	телятина
vegetables	овощи (от vegetable)
vegetable	овощ, растение, овощной
vegetation	растительность 
vehemently	сильно
vehicle	транспортное средство
veil	завеса, покрывало
vein	вена, жила, жилка
velvet	бархат, преимущество
veneering	облицовывание
vengeance	месть, мщение
ventures	предприятия (от venture)
venture	предприятие, риск
vent	выпускать, испускать
Venus	венера 
verandah	веранда 
verdure	зелень ***d***
verge	грань, край
verify	проверять, подтверждать
verse	стихи, поэзия
versions	версии 
version	версия
vertically	вертикально 
vertical	вертикальный
very	очень, тот самый
vessel	сосуд, судно
vest	жилет (амер.), майка
veteran	ветеран
vexation	досада, раздражение (не nuisance)
vexed	сердил, раздражал (от vex)
vex	раздражать, сердить
via	через
vice	порок
vicinity	окрестности, соседство, близость
vicious	порочный
victim	жертва
victorious	победоносный
victory	победа
viewed	рассматриваемый 
viewpoint	точка зрения
views	представления(виды) 
view	взгляд, мнение, осматривать
vigilance	бдительность
vigorously	энергично (!NEW!)
vigorous	сильный
vigour	сила, энергия
villager	сельский житель
village	деревня
villain	злодей, негодяй
vinegar	уксус
vine	виноградная лоза
violence	сила, неистовство, насилие
violently	неистово
violent	яростный
violet	фиолетовый (не purple)
virtual	фактический
virtue	добродетель
viscount	виконт 
visible	видимый, очевидный
vision	зрение, видение
visited	посетил (от visit)
visiting	приезжий
visitor	гость
visits	посещения 
visit	визит, посещать, навещать
visual	зрительный, наглядный
vital	жизненный, крайне необходимый
vivid	живой, яркий
vocation	призвание
voice	голос
void	лишенный, недействительный (юр.)
volcano	вулкан
volume	объем, громкость
voluntary	добровольный
vote	голос (на выборах), голосование, голосовать
vow	обет, клятва
voyage	путешествие
wade	пробираться, продираться
wad	прокладывать
wager	держать пари, рисковать
wage	заработная плата
waggoner	извозчик 
wagon	повозка (!NEW!)
wag	махать, трясти
wailed	вопил 
wailing	вопящий
wail	вопль, вой, вопить, выть
waistcoat	жилет
waist	талия
waited	ждал (от wait)
waiter	официант
waiter	официант
waiting	ждать (от to keep waiting)
waitress	официантка
waitress	официантка
wait	ждать, ожидать, ожидание
wake	будить, просыпаться
walked	гулял (от walk)
walking	гуляющий
walk	гулять, ходить пешком (не hike)
wallet	бумажник
wallpaper	обои
wall	стена
walnut	грецкий орех
walrus	морж
Walter	уолтер 
wanderer	странник (не stranger)
wandering	блуждание (!NEW!)
wander	бродить, блуждать
wand	палочка 
wanted	хотел, желанный (от want)
wanting	Желание 
wants	хочет, желает, нуждается в (от want)
want	хотеть, желать, нуждаться в
wan	бледный, изнуренный
wardrobe	гардероб
ward	опека
warehouse	склад, пакгауз
warily	осторожно
warmly	тепло ( как?  тепло!)
warmth	тепло, теплота, сердечность
warm	теплый, согревать
warning	предупреждение
warn	предупреждать
warrant	полномочие, ордер, гарантировать
warriors	воины 
warrior	воин
wars	войны 
wary	осторожный
war	война, воевать
washed	мыл, вымытый (от wash)
wash	мыть, стирать, мытье, стирка
waspish	злой, раздражительный (не vicious)
wasp	оса
wasted	потраченный впустую 
wasteful	расточительный
waste	тратить, использованный, негодный
was	был (от be)
watcher	сторож, наблюдатель
watches	часы (от watch)
watchful	бдительный (не vigilant)
watching	просмотр
watchman	(ночной) сторож
watch	часы, cмотреть, наблюдать
waterproof	непромокаемый, непромокаемый плащ
watery	водянистый, дождевой, бесцветный
water	вода, поливать, разбавлять
waved	махал 
waver	колебаться, быть в нерешительности
wave	волна
waving	помахивание 
wavy	волнистый, бурный
waxworks	восковые фигуры 
wax	воск, восковой
wayfarer	путник, пешеход
way	дорога, путь, способ
weakness	слабость
weak	слабый
wealthy	богатый
wealth	богатство
weapons	оружие 
weapon	оружие
weariness	усталость
wearisome	скучный, надоедливый
weary	усталый, утомительный, утомлять(ся), устать, потерять терпение
wear	одежда, носить, быть одетым
weather	погода
weave	ткать, плести
web	ткань, лента, перемычка
wedding	свадьба, венчание
wedge	клин
Wednesday	среда
weed	сорняк, полоть
weekend	выходные
weekly	еженедельный, еженедельно
week	неделя
weeping	плач
weep	плакать
weighty	веский
weight	вес, тяжесть, груз
weigh	взвешивать, весить
weird	судьба, рок, таинственный, странный
Welcome	желанный, гостеприимство
welfare	благосостояние
well	хорошо, очень, добро, здоровый (не good)
went	шел, ехал (от go)
wept	плакал 
were	были (от be)
western	западный
west	запад
wet	мокрый
we	мы
whale	кит
whatever	что бы ни
what	что, какой
wheat	пшеница
wheelbarrow	тачка
wheeled	колесный 
wheels	колеса 
wheel	колесо
whence	откуда 
whenever	когда бы ни
when	когда
whereas	тогда как, принимая во внимание
whereby	чем, при помощи
whereupon	после чего, сразу после; немедленно после
wherever	где бы ни, куда бы ни
where	где, куда
whether	ли
which	который
while	пока, в то время как, тогда как
whilst	пока 
whine	визг, скулить
whip	кнут, хлыст, хлестать, сечь, взбивать (сливки, яйца)
whirlwind	вихрь
whirl	вихрь
whiskers	бакенбарды, усы (у животных)
whispering	шептание 
whisper	шепот, шептать
whistled	свистел 
whistle	свист, свистеть
whistling	свист 
white	белый
whoever	кто бы ни
wholesome	полезный, здоровый, благотворный
whole	целый, весь, целое
wholly	полностью
whom	кому, кого
whose	чей
who	кто
why	почему
wicked	злой
widely	широко
widen	расширять(ся)
wide	широкий
widow	вдова
width	ширина
wife	жена
wig	парик
wilderness	пустыня, глушь
wildly	дико 
wild	исступленный, безумный
william	уильям 
willingly	охотно
willing	готовый, охотно делающий что-либо
willow	ива
will	вспомогательный глагол будущего времени
windfall	неожиданная удача
winding	изгиб
windows	окна (от window)
window	окно, оконный
winds	ветры 
windy	ветреный
wind	ветер, виток, виться, наматывать
wine	вино, винный, пить вино
wings	крылья (!NEW!)
wing	крыло
wink	моргать, мигать, моргание, мигание
winner	победитель
winning	выигрывающий, победа (
winter	зима
win	выигрывать, побеждать
wiped	вытертый 
wipe	вытирать
wireless	беспроволочный, радио
wire	переводить телеграфом (деньги)
wisdom	мудрость
wisely	мудро
wise	мудрый
wishes	пожелания (от wish)
wishing	пожелание
wish	желание, желать
withdraw	брать назад, забирать
withdrew	отошел 
within	внутри, внутрь
without	без
with	с
witnessed	засвидетельствованный 
witness	свидетель
wits	остроумие 
wit	ум, остроумие, остроумный человек, остряк
wizards	волшебники 
wizard	колдун, специалист своего дела (!NEW!)
woken	разбуженный (от wake)
woke	будил (от wake)
wolf	волк
wolves	волки 
woman	женщина
women	женщины (от woman)
wonderfully	чудесно
wonderful	замечательный, чудесный
wondering	удивляющийся, интересующийся (
wonder	удивляться
won	победил, побежденный (от win)
wooden	деревянный
woodlands	лесистые местности 
woodland	лесистая местность
wood	лес, древесина, дрова
woollen	шерстяной
wool	шерсть
wording	редакция, форма выражения, формулировка
words	слова (от word)
word	слово, обещание
wore	носил, изнашивал
worked	работал, сработанный (от work)
worker	рабочий
working	делающий, творящий (от work)
workman	рабочий (мужик)
workroom	рабочее помещение 
workshop	мастерская
work	работать, делать, работа, труд
world	мир, свет
worm	червь, глист, ничтожество (перен.)
worn	потёртый, изношенный (!NEW!)
worry	беспокоиться
worse	хуже (от bad)
worship	поклоняться (не regards)
worst	наихудший
worthless	ничего не стоящий, дрянной
worthy	достойный
worth	стоящий, заслуживающий
would	вспомогательный, модальный глагол (от will)
wounded	раненый
wound	рана
wow	ничего себе 
wrap	завертывать, шаль, плед, обертка
wrath	гнев, ярость
wreck	крушение
wren	крапивник 
wrestle	бороться
wretched	несчастный, жалкий
wretch	несчастный, негодяй
wring	скручивать, выжимать
wrinkle	морщина, морщить(ся)
wrist	наручный, запястье
writer	писатель
write	писать, записывать
writing	письменность (
written	письменный, написанный
wrong	неправильный, не тот
wrote	писал, написанный (от write)
yacht	яхта
yard	ярд, двор
yawn	зевать, зевота
yeah	да (!NEW!)
yearling	козленок, ягненок
year	год
yellow	желтый
yell	пронзительный крик, кричать, вопить
yesterday	вчера
yes	да
yet	однако, еще
ye	вы 
yielded	выданный 
yielding	выдающий(уступающий)
yield	приносить
yoke	иго, ярмо
yonder	вон тот (!NEW!)
younger	моложе (от young)
youngest	самый молодой, младший (от young)
youngster	юноша
young	молодой
yourself	сам, сами
yourselves	самостоятельно 
yours	ваш, ваши, твой, твои
your	ваш, твой
youthful	юный, юношеский
youth	молодежь
you	вы, ты
zeal	усердие, рвение
zero	ноль
zigzag	зигзаг 
zinc	цинк, цинковый, оцинковывать
zone	зона
zoological	зоологический 
zoo	зоопарк
