ability	evne 
able	có thể 
about	trong khoảng 
above	ở trên 
absence	vắng mặt 
absolutely	tuyệt đối 
accident	tai nạn 
account	tài khoản 
across	băng qua 
action	hoạt động 
activity	hoạt động 
actually	thực ra 
advantage	lợi thế 
adventure	phiêu lưu 
advice	lời khuyên 
affair	ngoại tình 
affection	tình cảm 
afraid	sợ 
afternoon	buổi chiều 
after	sau 
afterwards	về sau 
again	lần nữa 
against	chống lại 
agent	đại lý 
age	tuổi tác 
ago	trước đây 
ahead	phía trước 
aid	viện trợ 
air	không khí 
alarm	báo động 
alive	sống sót 
all	tất cả các 
almost	hầu hết 
alone	một mình 
along	dọc theo 
already	đã 
also	cũng thế 
although	mặc dầu 
altogether	hoàn toàn 
always	luôn luôn 
America	Mỹ 
American	Người Mỹ 
among	trong số 
a	một 
amount	số tiền 
ancient	cổ đại 
and	và 
angel	thiên thần 
anger	Sự phẫn nộ 
angry	bực bội 
animal	thú vật 
an	một 
another	khác 
anxious	lo lắng 
any	bất kì 
anybody	bất cứ ai 
anymore	nữa 
anyone	bất kỳ ai 
anything	bất cứ điều gì 
anyway	dù sao 
anywhere	nơi nào 
apartment	căn hộ, chung cư 
apart	riêng biệt 
apparently	rõ ràng 
appearance	ngoại hình 
April	tháng tư 
area	khu vực 
argument	tranh luận 
arm	cánh tay 
army	quân đội 
around	xung quanh 
arrangement	sắp xếp 
arrival	đến 
article	bài viết 
artist	họa sĩ 
art	nghệ thuật 
aside	sang một bên 
asleep	ngủ say 
as	như 
aspect	diện mạo 
ass	đít 
attack	tấn công 
at	tại 
attempt	cố gắng 
attention	chú ý 
attitude	thái độ 
audience	khán giả 
August	tháng tám 
aunt	dì 
authority	thẩm quyền 
author	tác giả 
awake	thức dậy 
aware	nhận thức 
away	xa 
awful	đáng sợ 
baby	đứa bé 
background	lý lịch 
back	trở lại 
badly	nặng 
bad	xấu 
bag	túi 
balance	cân đối 
ball	trái bóng 
band	ban nhạc 
bank	ngân hàng 
barely	hầu như không 
bare	trần 
bar	quán ba 
base	cơ sở 
basket	bóng rổ 
bathroom	phòng tắm 
battle	trận chiến 
beach	bãi biển 
beam	cây đà 
beast	súc vật 
beautiful	đẹp 
beauty	sắc đẹp, vẻ đẹp 
because	bởi vì 
bed	Giường 
bedroom	phòng ngủ 
beer	chịu 
before	trước 
beginning	bắt đầu 
behind	phía sau 
being	được 
belief	niềm tin 
bell	chuông 
belly	bụng 
below	phía dưới 
belt	dây lưng 
bench	ghế dài 
beneath	ở trên 
benefit	lợi ích 
beside	bên cạnh 
besides	vả lại 
between	giữa 
beyond	vượt ra ngoài 
big	lớn 
bill	hóa đơn 
bird	chim 
birth	sinh 
bitter	đắng 
black	đen 
blade	lá 
blanket	hình thức 
blind	mù 
block	khối 
blood	máu 
bloody	dính máu 
blue	màu xanh da trời 
board	bảng 
boat	thuyền 
body	thân hình 
bone	xương 
book	sách 
boot	thuyền 
border	biên giới 
both	cả hai 
bottle	chai 
bottom	dưới cùng 
bound	ràng buộc 
bowl	bát 
box	cái hộp 
boy	con trai 
brain	não 
branch	chi nhánh 
brave	can đảm 
bread	bánh mì 
breakfast	bữa sáng 
breast	nhũ hoa 
breath	hơi thở 
breeze	gió 
bridge	cầu 
bright	sáng 
brilliant	rực rỡ 
British	Anh 
broad	rộng 
broken	bị hỏng 
brother	em trai 
brown	nâu 
brow	trán 
building	Tòa nhà 
bullet	đạn 
bush	bụi cây 
business	kinh doanh 
bus	xe buýt 
busy	bận 
but	nhưng 
button	nút 
by	bởi 
calm	điềm tĩnh 
camera	máy chụp ảnh 
camp	trại 
candle	nến 
capable	có khả năng 
cap	mũ lưỡi trai 
captain	đội trưởng 
card	Thẻ 
career	nghề nghiệp 
careful	cẩn thận 
carefully	cẩn thận 
carriage	vận chuyển 
car	xe hơi 
case	trường hợp 
castle	lâu đài 
cat	mèo 
cave	hang 
ceiling	trần nhà 
cell	tế bào 
center	trung tâm 
century	thế kỷ 
certainly	chắc chắn 
certain	nhất định 
chain	chuỗi 
chair	cái ghế 
challenge	thách 
chamber	phòng 
chance	cơ hội 
chapter	chương 
character	tính cách 
charge	sạc điện 
charm	quyến rũ 
cheek	má 
chest	ngực 
chief	trưởng 
child	đứa trẻ 
chin	cằm 
Chinese	Trung Quốc 
choice	sự lựa chọn 
Christ	Chúa Kitô 
Christian	Cơ đốc giáo 
Christmas	Giáng sinh 
church	nhà thờ 
cigarette	thuốc lá 
circle	vòng tròn 
circumstance	hoàn cảnh 
citizen	công dân 
city	thành phố 
class	lớp học 
clean	dọn dẹp 
clearly	rõ ràng 
clear	thông thoáng 
clerk	nhân viên bán hàng 
clock	đồng hồ 
closely	chặt chẽ 
clothes	quần áo 
cloth	vải 
cloud	đám mây 
club	câu lạc bộ 
coat	áo khoác 
coffee	cà phê 
cold	lạnh 
college	cao đẳng 
color	màu 
colour	màu 
comfortable	thoải mái 
comfort	thoải mái 
command	chỉ huy 
comment	bình luận 
common	chung 
community	cộng đồng 
companion	đồng hành 
company	Công ty 
complete	hoàn thành 
completely	hoàn toàn 
computer	máy tính 
conclusion	konkluderer 
condition	điều kiện 
confidence	tự tin 
confusion	nhầm lẫn 
connection	liên quan 
conscious	có ý thức 
consciousness	ý thức 
consequence	konsekvens 
contact	liên hệ 
content	nội dung 
control	điều khiển 
conversation	cuộc hội thoại 
cool	mát mẻ 
cop	cảnh sát viên 
corner	góc 
correct	đúng 
corridor	hành lang 
cost	chi phí 
cottage	nhà tranh 
couch	đi văng 
could	có thể 
counter	quầy 
country	Quốc gia 
couple	cặp vợ chồng 
courage	lòng can đảm 
course	khóa học 
court	tòa án 
cousin	anh em họ 
cow	bò 
crazy	điên 
creature	sinh vật 
credit	thẻ tín dụng 
crew	phi hành đoàn 
crime	tội phạm 
criminal	hình sự 
crowd	đám đông 
crown	tôn lên 
culture	văn hóa 
cup	cốc 
curiosity	tò mò 
curious	tò mò 
current	hiện tại 
curtain	màn 
curve	đường cong 
custom	phong tục 
dad	cha 
daily	hằng ngày 
damage	tổn thất 
damn	chết tiệt 
danger	nguy hiểm 
dangerous	nguy hiểm 
darkness	bóng tối 
dark	tối 
darling	người yêu 
date	ngày 
daughter	Con gái 
dawn	bình minh 
day	ngày 
dead	đã chết 
deal	thỏa thuận 
dear	kính thưa 
death	tử vong 
decision	quyết định 
deck	boong 
deeply	sâu sắc 
deep	sâu 
degree	bằng cấp 
delicate	tinh vi 
delight	vui mừng 
department	sở 
depth	chiều sâu 
description	miêu tả 
desert	sa mạc 
design	thiết kế 
desire	khao khát 
desk	bàn 
despair	tuyệt vọng 
desperate	tuyệt vọng 
despite	trots 
detail	chi tiết 
detective	thám tử 
development	phát triển 
devil	ác quỷ 
difference	Sự khác biệt 
different	khác nhau 
difficult	khó khăn 
difficulty	khó khăn 
dining	ăn uống 
dinner	bữa tối 
direction	phương hướng 
directly	trực tiếp 
dirt	bụi 
dirty	dơ bẩn 
discussion	thảo luận 
distance	khoảng cách 
distant	xa 
doctor	Bác sĩ 
dog	chó 
dollar	đô la 
door	cửa 
doorway	ô cửa 
double	gấp đôi 
doubt	nghi ngờ 
down	xuống 
dozen	hộp 
dread	kinh sợ 
dream	mơ tưởng 
driver	lái xe 
drug	ma túy 
drunk	say 
dry	khô 
due	do 
dull	đần độn 
during	suốt trong 
dust	bụi 
duty	nhiệm vụ 
each	mỗi 
eager	hăng hái 
early	sớm 
ear	tai 
earth	trái đất 
easily	dễ dàng 
east	đông 
easy	dễ dàng 
edge	cạnh 
education	sự giáo dục 
effect	hiệu ứng 
effort	cố gắng 
egg	trứng 
eight	tám 
either	hoặc 
elbow	khuỷu tay 
element	yếu tố 
else	khác 
emotion	cảm xúc 
empty	trống 
end	kết thúc 
enemy	kẻ thù 
energy	năng lượng 
engine	động cơ 
England	nước Anh 
English	Anh 
enormous	enorme 
enough	đủ 
entirely	hoàn toàn 
entire	toàn bộ 
entrance	lối vào 
equal	bằng 
equally	lika 
especially	đặc biệt 
estate	tài sản 
Europe	Âu châu 
even	cũng 
evening	tối 
event	biến cố 
eventually	sau cùng 
ever	không bao giờ 
everybody	mọi người 
every	mỗi 
everyone	tất cả mọi người 
everything	mọi điều 
everywhere	khắp nơi 
evidence	bằng chứng 
evil	ác 
exactly	chính xác 
example	thí dụ 
excellent	xuất sắc 
except	ngoại trừ 
excitement	phấn khích 
excuse	xin lỗi 
exercise	tập thể dục 
existence	sự tồn tại 
experience	kinh nghiệm 
explanation	giải thích 
expression	biểu hiện 
extra	thêm 
extremely	vô cùng 
eyebrow	lông mày 
eye	mắt 
face	đối mặt 
fact	thực tế 
faint	ngất xỉu 
fair	hội chợ 
fairly	khá 
faith	đức tin 
familiar	quen thuộc 
family	gia đình 
famous	nổi tiếng 
fancy	ưa thích 
farm	trang trại 
far	xa 
fashion	thời trang 
fast	Nhanh 
fat	béo 
fate	số phận 
father	cha 
fault	lỗi 
favorite	yêu thích 
favor	ủng hộ 
fear	nỗi sợ 
feature	tính năng 
feeling	cảm giác 
fellow	đồng bào 
female	nữ 
fence	hàng rào 
few	vài 
fiction	viễn tưởng 
field	cánh đồng 
fifteen	mười lăm 
fifty	năm mươi 
figure	nhân vật 
file	tập tin 
film	phim ảnh 
final	chung kết 
finally	cuối cùng 
fine	khỏe 
finger	ngón tay 
fire	ngọn lửa 
firm	công ty 
firmly	kiên quyết 
first	Đầu tiên 
fish	cá 
fist	nắm tay 
five	số năm 
flame	ngọn lửa 
flat	căn hộ 
flesh	thịt 
flight	chuyến bay 
flood	lũ 
floor	sàn nhà 
flower	hoa 
folk	dân gian 
following	tiếp theo 
food	món ăn 
fool	ngu xuẩn 
foot	chân 
force	lực lượng 
for	cho 
forehead	trán 
foreign	ngoại quốc 
forest	rừng 
forever	mãi mãi 
former	trước đây 
form	hình thức 
forth	ra 
fortune	tài lộc 
forty	bốn mươi 
forward	phía trước 
four	bốn 
frame	khung 
France	Pháp 
freedom	sự tự do 
free	miễn phí 
French	người Pháp 
fresh	tươi 
friend	bạn 
friendly	thân thiện 
friendship	tình bạn 
from	từ 
front	trước mặt 
fruit	quả 
full	đầy 
fully	đầy đủ 
funeral	đám ma 
funny	buồn cười 
fun	vui vẻ 
future	Tương lai 
game	trò chơi 
garden	vườn 
gate	cánh cổng 
gay	đồng tính 
gaze	ánh mắt 
general	chung 
generally	generelt 
generation	thế hệ 
gentleman	quý ông 
gentle	nhẹ nhàng 
gently	nhẹ nhàng 
German	tiếng Đức 
gesture	cử chỉ 
ghost	ma 
giant	người khổng lồ 
gift	quà tặng 
girl	con gái 
glad	vui vẻ 
glasses	kính 
glass	ly 
glow	phát sáng 
god	chúa ơi 
God	Thượng Đế 
golden	vàng 
gold	vàng 
good	tốt 
government	chính quyền 
gown	áo choàng 
grace	vẻ duyên dáng 
grandfather	ông nội 
grand	lớn 
grandmother	bà ngoại 
grass	cỏ 
grateful	biết ơn 
grave	mộ 
gray	màu xám 
great	tuyệt quá 
Greek	Hy Lạp 
green	màu xanh lá 
grey	màu xám 
grief	sự đau khổ 
grip	nắm 
ground	đất 
group	nhóm 
guard	bảo vệ 
guest	khách 
guilty	có tội 
gun	súng 
guy	chàng 
habit	thói quen 
hair	tóc 
half	một nửa 
hall	đại sảnh 
handsome	đẹp trai 
hand	tay 
happiness	hạnh phúc 
happy	vui mừng 
hard	cứng 
hardly	khó khăn 
harm	phẩn nộ 
hat	mũ 
head	cái đầu 
health	sức khỏe 
he	anh ấy 
heart	tim 
heat	nhiệt 
heaven	thiên đường 
heavily	nặng nề 
heavy	nặng 
heel	gót chân 
height	chiều cao 
hell	Địa ngục 
her	cô ấy 
here	đây 
hero	anh hùng 
hers	của cô ấy 
herself	chính mình 
high	cao 
highly	đánh giá cao 
hill	đồi núi 
him	anh ta 
himself	bản thân anh ấy 
hint	dấu 
hip	hông 
his	của anh ấy 
history	lịch sử 
hole	lỗ 
home	nhà 
honest	trung thực 
honor	danh dự 
honour	danh dự 
horror	kinh dị 
horse	con ngựa 
hospital	bệnh viện 
hotel	khách sạn 
hot	nóng bức 
hour	giờ 
house	nhà ở 
however	Tuy nhiên 
how	làm sao 
huge	khổng lồ 
human	Nhân loại 
hundred	trăm 
hungry	đói 
husband	người chồng 
ice	băng 
idea	ý kiến 
if	nếu 
ill	bệnh 
image	hình ảnh 
imagination	sự tưởng tượng 
immediately	ngay 
importance	viktigheten 
important	quan trọng 
impossible	Không thể nào 
impression	ấn tượng 
indeed	thật 
Indian	người Ấn Độ 
individual	cá nhân 
influence	ảnh hưởng 
innocent	ngây thơ 
inside	phía trong 
instance	ví dụ 
instantly	lập tức 
instant	ngay lập tức 
instead	thay thế 
intelligence	sự thông minh 
intention	mục đích 
interested	marry 
interesting	thú vị 
interest	quan tâm 
interview	phỏng vấn 
into	vào 
in	trong 
iron	sắt 
island	đảo 
issue	vấn đề 
Italian	Ý 
it	nó 
I	tôi 
itself	chinh no 
its	nó là 
jacket	áo khoác 
jaw	hàm 
Jew	người Do Thái 
job	việc làm 
joke	đùa 
journey	hành trình 
joy	niềm vui 
judge	thẩm phán 
judgment	Judgment 
July	tháng bảy 
June	tháng sáu 
just	chỉ 
justice	sự công bằng 
key	Chìa khóa 
kid	đứa trẻ 
kind	loại 
king	nhà vua 
kitchen	phòng bếp 
knee	đầu gối 
knife	dao 
knight	hiệp sĩ 
knowledge	kiến thức 
lack	thiếu 
lad	rời khỏi 
lady	quý bà 
lake	hồ 
lamp	đèn 
land	đất 
language	ngôn ngữ 
lap	vạt áo 
large	lớn 
last	Cuối cùng 
late	muộn 
latter	cái sau 
laughter	tiếng cười 
law	luật 
lawyer	luật sư 
leader	lãnh đạo 
least	ít nhất 
leather	da 
left	trái 
legal	hợp pháp 
leg	Chân 
length	chiều dài 
less	ít hơn 
lesson	bài học 
letter	lá thư 
level	cấp độ 
library	thư viện 
life	đời sống 
light	ánh sáng 
lightly	nhẹ nhàng 
likely	có khả năng 
like	như 
limit	giới hạn 
line	hàng 
link	liên kết 
lip	môi 
list	danh sách 
literary	văn học 
little	ít 
living	sống 
local	địa phương 
lonely	lẻ loi 
long	Dài 
loose	lỏng lẻo 
lord	Chúa 
Lord	Chúa tể 
loss	mất mát 
lot	nhiều 
loud	to tiếng 
lovely	đáng yêu 
lover	người yêu 
low	thấp 
luck	may mắn 
lucky	may mắn 
lunch	bữa trưa 
machine	máy 
mad	điên 
magazine	tạp chí 
magic	ma thuật 
maid	thiếu nữ 
mail	email 
main	chủ yếu 
major	chuyên ngành 
male	nam 
man	Đàn ông 
manner	cách thức 
many	nhiều 
map	bản đồ 
March	hành khúc 
market	thị trường 
marriage	kết hôn 
mass	khối lượng 
master	bậc thầy 
match	trận đấu 
material	vật liệu 
matter	vấn đề 
maybe	có lẽ 
meal	bữa ăn 
meaning	ý nghĩa 
measure	biện pháp 
meat	thịt 
medical	y khoa 
meeting	gặp gỡ 
member	hội viên 
memory	ký ức 
mental	trí óc 
mere	chỉ 
merely	chỉ đơn thuần là 
message	thông điệp 
mess	sự lộn xộn 
metal	kim loại 
method	phương pháp 
me	tôi 
middle	ở giữa 
mile	dặm 
military	quân đội 
milk	sữa 
million	triệu 
mind	lí trí 
mine	của tôi 
minister	bộ trưởng 
minute	phút 
mirror	gương 
Miss	Bỏ lỡ 
mission	nhiệm vụ 
mistake	sai lầm 
mistress	tình nhân 
model	kiểu mẫu 
modern	hiện đại 
moment	chốc lát 
money	tiền bạc 
month	tháng 
mood	tâm trạng 
moon	mặt trăng 
moral	đạo đức 
more	hơn 
morning	buổi sáng 
mostly	chủ yếu 
most	phần lớn 
mother	mẹ 
motion	chuyển động 
mountain	núi 
mouth	miệng 
movement	phong trào 
movie	phim 
Mr	Ông 
Mrs	Bà 
much	nhiều 
murder	giết người 
muscle	bắp thịt 
music	Âm nhạc 
my	của tôi 
myself	riêng tôi 
mystery	điều bí ẩn 
nail	móng tay 
naked	trần truồng 
name	Tên 
narrow	hẹp 
nation	quốc gia 
native	tự nhiên 
naturally	một cách tự nhiên 
natural	tự nhiên 
nature	Thiên nhiên 
nearly	Gần 
near	ở gần 
necessary	cần thiết 
neck	cái cổ 
neighbor	hàng xóm 
neither	cũng không 
nerve	thần kinh 
nervous	hồi hộp 
never	không bao giờ 
new	Mới 
newspaper	báo 
news	Tin tức 
next	kế tiếp 
nice	tốt đẹp 
night	đêm 
nine	chín 
noble	cao quý 
nobody	không ai 
noise	tiếng ồn 
no	Không 
none	không ai 
nor	cũng không 
normal	bình thường 
north	phía bắc 
nose	mũi 
note	chú thích 
nothing	không có gì 
notion	khái niệm 
not	không phải 
novel	tiểu thuyết 
now	hiện nay 
number	con số 
nurse	y tá 
object	vật 
obvious	hiển nhiên 
obviously	rõ ràng 
occasion	dịp 
ocean	đại dương 
o’clock	giờ 
odd	lẻ 
of	của 
officer	nhân viên văn phòng 
office	văn phòng 
official	chính thức 
off	tắt 
often	thường xuyên 
oil	dầu 
okay	được rồi 
old	cũ 
once	Một lần 
one	một 
only	chỉ có 
onto	trên 
on	trên 
opening	mở ra 
operation	phẫu thuật 
opinion	ý kiến 
opportunity	cơ hội 
opposite	ngược lại 
order	gọi món 
ordinary	bình thường 
or	hoặc là 
original	bản gốc 
other	khác 
others	khác 
otherwise	mặt khác 
our	của chúng tôi 
ourselves	chính chúng ta 
out	ngoài 
outside	ở ngoài 
over	kết thúc 
owner	chủ nhân 
own	sở hữu 
pace	tốc độ 
page	trang 
pain	đau đớn 
painting	bức tranh 
pair	đôi 
palace	cung điện 
pale	nhợt nhạt 
palm	lòng bàn tay 
paper	giấy 
parent	cha mẹ 
park	công viên 
particular	cụ thể 
particularly	đặc biệt 
partner	đối tác 
part	phần 
party	buổi tiệc 
passage	đoạn văn 
passenger	hành khách 
passion	đam mê 
past	quá khứ 
path	con đường 
patient	bệnh nhân 
pattern	mẫu 
peace	hòa bình 
pen	cây bút 
perfect	hoàn hảo 
perfectly	hoàn hảo 
perhaps	có lẽ 
period	giai đoạn 
permission	sự cho phép 
per	mỗi 
personal	cá nhân 
person	người 
phone	điện thoại 
photograph	chụp hình 
phrase	cụm từ 
physical	thể chất 
picture	hình ảnh 
piece	cái 
pile	cọc 
pillow	cái gối 
pink	ngón tay út 
pipe	ống 
pistol	súng 
pity	thương hại 
place	địa điểm 
plain	đồng bằng 
plane	máy bay 
plan	kế hoạch 
plant	nhà máy 
plate	tấm 
pleasant	dễ chịu 
pleasure	vui lòng 
plenty	nhiều 
plot	âm mưu 
pocket	túi 
poem	bài thơ 
poetry	thơ phú 
poet	thi sĩ 
point	điểm 
police	cảnh sát 
political	chính trị 
pool	hồ bơi 
poor	nghèo nàn 
popular	phổ biến 
porch	cổng 
position	Chức vụ 
possession	sở hữu 
possibility	khả năng 
possible	khả thi 
possibly	có thể 
post	bài 
pot	nồi 
pound	pao 
powerful	mạnh mẽ 
power	quyền lực 
practice	thực hành 
praise	lời khen ngợi 
prayer	cầu nguyện 
precious	quí 
presence	sự hiện diện 
present	hiện tại 
pressure	áp lực 
pretty	đẹp 
previous	trước 
price	giá 
pride	niềm tự hào 
priest	linh mục 
prince	hoàng tử 
principle	nguyên tắc 
prisoner	tù nhân 
prison	nhà tù 
private	riêng tư 
probably	có lẽ 
problem	vấn đề 
process	quá trình 
professional	chuyên nghiệp 
progress	tiến bộ 
project	dự án 
proof	bằng chứng 
proper	sạch sẽ 
property	tài sản 
proud	tự hào 
public	công cộng 
pure	tinh khiết 
purpose	mục đích 
purse	túi 
quality	chất lượng 
quarter	quý 
queen	nữ hoàng 
question	câu hỏi 
quickly	Mau 
quick	nhanh chóng 
quietly	lặng lẽ 
quiet	Yên tĩnh 
quite	khá 
race	cuộc đua 
rage	cơn sốt 
rain	mưa 
range	phạm vi 
rank	đẳng cấp 
rapidly	nhanh chóng 
rare	đẹp 
rate	tỷ lệ 
rather	hơn 
reaction	sự phản ứng 
ready	sẳn sàng 
reality	thực tế 
really	có thật không 
real	thực 
rear	phía sau 
reason	lý do 
recently	mới đây 
recent	senaste 
record	ghi lại 
red	màu đỏ 
reflection	sự phản xạ 
regular	đều đặn 
relation	quan hệ 
relationship	mối quan hệ 
relative	họ hàng 
relief	cứu trợ 
religion	tôn giáo 
religious	tôn giáo 
report	bài báo cáo 
request	yêu cầu 
respect	sự tôn trọng 
response	đáp ứng 
responsibility	trách nhiệm 
responsible	ansvarlig 
restaurant	nhà hàng 
rest	nghỉ ngơi 
result	kết quả 
rich	giàu có 
rifle	súng trường 
right	đúng 
ring	nhẫn 
risk	rủi ro 
river	con sông 
road	đường 
rock	đá 
role	Rolle 
Roman	tiểu thuyết 
Rome	Roma 
roof	cướp 
room	phòng 
root	nguồn gốc 
rope	dây thừng 
rough	thô 
round	tròn 
row	hàng 
rule	quy tắc 
Russian	Tiếng nga 
sacrifice	hy sinh 
sad	buồn 
saddle	yên xe 
safe	an toàn 
safety	sự an toàn 
sake	vì lợi ích 
same	tương tự 
sand	cát 
satisfaction	sự hài lòng 
Saturday	thứ bảy 
scarcely	hiếm 
scene	bối cảnh 
scent	hương thơm 
school	trường học 
science	khoa học 
screen	màn hình 
sea	biển 
season	mùa 
seated	ngồi 
seat	ghế 
second	thứ hai 
secret	bí mật 
section	tiết diện 
security	an ninh 
sense	giác quan 
sentence	câu 
series	loạt 
seriously	nghiêm túc 
serious	nghiêm trọng 
servant	người hầu 
service	dịch vụ 
seven	bảy 
several	một số 
sex	tình dục 
sexual	tình dục 
shade	bóng râm 
shadow	bóng 
shame	xấu hổ 
shape	hình dạng 
sharp	nhọn 
she	bà ấy 
sheet	tờ 
shell	vỏ trứng 
shelter	che chở 
ship	tàu 
shirt	áo sơ mi 
shit	đi tiêu 
shock	sốc 
shoe	giày 
shop	cửa tiệm 
shore	bờ 
short	ngắn 
shot	bắn 
shoulder	vai 
should	Nên 
shower	vòi hoa sen 
sick	đau ốm 
side	bên 
sight	thị giác 
signal	tín hiệu 
sign	ký tên 
silence	khoảng lặng 
silent	im lặng 
silently	âm thầm 
silk	lụa 
silly	điên 
silver	bạc 
similar	tương tự 
simple	đơn giản 
simply	đơn giản 
since	kể từ khi 
sin	của nó 
single	Độc thân 
sir	quý ngài 
sister	em gái 
situation	tình hình 
six	sáu 
size	kích thước 
skill	kỹ năng 
skin	da 
skirt	váy 
sky	bầu trời 
slave	nô lệ 
slightly	khinh bỉ 
slight	nhẹ 
slope	dốc 
slow	chậm 
slowly	chậm rãi 
small	nhỏ bé 
smart	thông minh 
smoke	hút thuốc lá 
smooth	mịn 
snow	tuyết 
social	xã hội 
society	xã hội 
sofa	giường 
softly	nhẹ nhàng 
soft	mềm mại 
soldier	lính 
solid	chắc 
somebody	ai đó 
somehow	bằng cách nào đó 
some	một số 
someone	người nào 
something	một cái gì đó 
sometimes	đôi khi 
somewhat	phần nào 
somewhere	một vài nơi 
son	Con trai 
song	bài hát 
soon	Sớm 
sorrow	nỗi buồn 
sorry	lấy làm tiếc 
sort	sắp xếp 
soul	Linh hồn 
sound	âm thanh 
source	nguồn 
south	phía nam 
so	vì thế 
space	không gian 
Spanish	Tây Ban Nha 
special	đặc biệt 
speech	bài phát biểu 
speed	tốc độ 
spell	đánh vần 
spirit	tinh thần 
spite	mặc dù 
spot	nơi 
spring	mùa xuân 
square	hình vuông 
staff	nhân viên 
stage	thực tập 
stair	cầu thang 
standard	tiêu chuẩn 
star	ngôi sao 
statement	tuyên bố 
state	tiểu bang 
station	ga tàu 
steady	vững chắc 
steel	thép 
step	bậc thang 
still	vẫn 
stock	chứng khoán 
stomach	dạ dày 
stone	cục đá 
store	cửa hàng 
storm	bão 
story	câu chuyện 
straight	thẳng 
strange	lạ 
stranger	người lạ 
stream	dòng 
street	đường phố 
strength	sức mạnh 
string	chuỗi 
stroke	đột quỵ 
strong	mạnh 
structure	cấu trúc 
student	sinh viên 
stuff	đồ đạc 
stupid	ngu ngốc 
style	phong cách 
subject	môn học 
successful	thành công 
success	thành công 
such	như là 
sudden	đột nhiên 
suddenly	đột ngột 
suit	bộ đồ 
summer	mùa hè 
Sunday	Chủ nhật 
sun	mặt trời 
supper	súp 
supply	cung cấp 
sure	chắc chắn rồi 
surely	chắc chắn 
surface	bề mặt 
suspicion	sự nghi ngờ 
sweat	mồ hôi 
sweet	ngọt 
sword	thanh kiếm 
sympathy	thông cảm 
system	hệ thống 
table	bàn 
tail	đuôi 
tale	câu chuyện 
tall	cao 
tape	băng 
task	nhiệm vụ 
taste	nếm thử 
teacher	giáo viên 
team	đội 
tear	nước mắt 
tea	trà 
telephone	điện thoại 
television	tivi 
temple	đền 
ten	mười 
tent	lều 
term	kỳ hạn 
terrible	kinh khủng 
terror	khủng bố 
test	kiểm tra 
text	bản văn 
than	hơn 
that	cái đó 
the	các 
thee	trà 
their	của chúng 
them	họ 
themselves	chính họ 
then	sau đó 
theory	lý thuyết 
therefore	vì thế 
there	ở đó 
these	những 
they	họ 
thick	dày 
thigh	bắp vế 
thin	gầy 
thing	Điều 
third	thứ ba 
thirty	ba mươi 
this	điều này 
those	những, cái đó 
thought	nghĩ 
though	Tuy nhiên 
thousand	ngàn 
threat	mối đe dọa 
three	số ba 
throat	họng 
throughout	khắp nơi 
through	xuyên qua 
thus	do đó 
thy	bạn 
tight	chặt chẽ 
till	cho đến 
time	thời gian 
tiny	nhỏ xíu 
tip	tiền boa 
to abandon	từ bỏ 
to accept	chấp nhận 
to accompany	đi cùng 
to accord	để phù hợp 
to accuse	buộc tội 
to ache	đau 
to acknowledge	thừa nhận 
to act	hành động 
to address	Đến địa chỉ 
to add	thêm 
to admire	chiêm ngưỡng 
to admit	thừa nhận 
to advance	để tiến lên 
to affect	ảnh hưởng 
to afford	đủ khả năng 
to agree	đồng ý 
to aim	nhằm mục đích 
to allow	cho phép 
to announce	thông báo 
to answer	để trả lời 
to appeal	để kháng cáo 
to appear	xuất hiện 
to apply	để áp dụng 
to appreciate	đánh giá cao 
to approach	để tiếp cận 
to argue	tranh luận 
to arise	phát sinh 
to arrange	sắp xếp 
to arrest	phán xét 
to arrive	đến 
to ask	hỏi 
to associate	liên kết 
to assume	giả định 
to assure	để đảm bảo 
to attach	đính kèm 
to attend	tham dự 
to attract	để thu hút 
to avoid	tránh 
to bear	chịu đựng 
to beat	để đánh bại 
to become	để trở thành 
to be	được 
to beg	cầu xin 
to begin	để bắt đầu 
to believe	tin tưởng 
to belong	thuộc về 
to bend	uốn cong 
to bet	đặt cược 
to betray	phản bội 
to bid	cầu nguyện 
to bite	cắn 
to blame	đổ lỗi 
to blink	tỏa sáng 
to blow	thổi 
to bore	khoan 
to bother	làm phiền 
to bow	cúi đầu 
to break	phá vỡ 
to breathe	thở 
to bring	mang lại 
to brush	đánh răng 
to build	xây dựng 
to burn	đốt cháy 
to burst	nổ tung 
to bury	chôn cất 
to buy	mua 
to call	để gọi 
to can	để có thể 
to capture	để nắm bắt 
to care	để chăm sóc 
to carry	để thực hiện 
to cast	để đúc 
to catch	để bắt 
to cause	gây ra 
to cease	chấm dứt 
to change	thay đổi 
to chase	đuổi theo 
to check	để kiểm tra 
to choose	chọn 
to chuckle	cười thầm 
to claim	để yêu cầu 
to climb	leo 
to cling	bám 
to close	đóng 
to clutch	để ly hợp 
to collect	để thu thập 
to come	đến 
to commit	cam kết 
to compare	để so sánh 
to complain	phàn nàn 
to conceal	để che giấu 
to concern	quan tâm 
to conclude	để kết luận 
to conduct	tiến hành 
to confess	thú nhận 
to confirm	để xác nhận 
to confuse	nhầm lẫn 
to connect	để kết nối 
to consider	cân nhắc 
to contain	để chứa 
to continue	tiếp tục 
to convince	để thuyết phục 
to cook	nấu ăn 
to count	để đếm 
to cover	để che 
to crack	để nứt 
to crash	sụp đổ 
to crawl	bò 
to create	để tạo ra 
to creep	để leo 
to cross	băng qua 
to crush	để nghiền nát 
to cry	khóc 
to curl	để cuộn tròn 
to curse	nguyền rủa 
to cut	cắt 
to dance	nhảy 
to dare	dám 
today	hôm nay 
to decide	quyết định 
to declare	tuyên bố 
to defend	để bảo vệ 
to deliver	để giao hàng 
to demand	để yêu cầu 
to	đến 
to deny	từ chối 
to depart	khởi hành 
to depend	phụ thuộc 
to descend	hạ xuống 
to describe	miêu tả 
to deserve	xứng đáng 
to destroy	phá hủy 
to determine	để xác định 
to develop	để phát triển 
to die	chết 
to dig	đào 
to direct	chỉ đạo 
to disappear	biến mất 
to discover	khám phá 
to discuss	thảo luận 
to display	để hiển thị 
to disturb	làm phiền 
to divide	chia rẽ 
to do	làm 
to drag	kéo 
to draw	vẽ 
to dress	ăn mặc 
to drift	trôi dạt 
to drink	uống 
to drive	lái xe 
to drop	để thả 
to earn	để kiếm tiền 
to ease	để dễ dàng 
to eat	ăn 
to echo	để lặp lại 
to embrace	để nắm lấy 
to emerge	nổi lên 
to employ	sử dụng 
to encounter	gặp phải 
to encourage	khuyến khích 
to engage	tham gia 
to enjoy	thưởng thức 
to enter	nhập 
to escape	trốn thoát 
to establish	thành lập 
to examine	kiểm tra 
to exchange	trao đổi 
to excite	kích thích 
to exclaim	kêu lên 
to exhaust	kiệt sức 
to exist	tồn tại 
to expect	mong đợi 
to explain	giải thích 
to expose	để lộ 
to express	bày tỏ 
to extend	mở rộng 
to fade	mờ dần 
to fail	thất bại 
to fall	ngã 
to feed	cho ăn 
to feel	để cảm nhận 
to fight	chiến đấu 
to fill	để điền 
to find	để tìm 
to finish	kêt thuc 
to fit	để phù hợp 
to fix	sửa chữa 
to flash	để flash 
to flee	bọ chét 
to fling	bỏ trốn 
to float	nổi 
to flow	chảy 
to fly	bay 
to focus	tập trung 
to fold	gấp 
to follow	để làm theo 
to forget	quên 
to forgive	tha thứ 
to freeze	đóng băng 
to frighten	sợ hãi 
to frown	nhăn mặt 
to gain	để đạt được 
to gasp	thở hổn hển 
to gather	để thu thập 
to get	để có được 
together	cùng với nhau 
to give	cho 
to glance	nhìn thoáng qua 
to glare	hai cái lườm 
to gleam	cười 
to go	đi 
to grab	để lấy 
to grant	cấp 
to grasp	để cỏ 
to greet	chào hỏi 
to grin	cười toe toét 
to groan	rên rỉ 
to grow	lớn lên 
to guess	đoán 
to guide	hướng dẫn 
to halt	hai què 
to handle	để xử lý 
to hang	treo 
to happen	xảy ra 
to hate	ghét 
to have	có 
to hear	nghe ngóng 
to help	giúp đỡ 
to hesitate	do dự 
to hide	trốn 
to hire	thuê 
to hit	đánh 
to hold	để giữ 
to hope	hy vọng 
to hug	ôm 
to hunt	đi săn 
to hurry	vội vàng 
to hurt	làm đau 
to identify	để xác định 
to ignore	bỏ qua 
to imagine	tưởng tượng 
to impress	để gây ấn tượng 
to include	bao gồm 
to increase	tăng 
to indicate	để chỉ ra 
to inform	để thông báo 
to inquire	để hỏi 
to insist	nhấn mạnh 
to intend	để ý 
to interrupt	làm gián đoạn 
to introduce	giới thiệu 
to invite	mời 
to involve	liên quan 
to jerk	giật 
to join	tham gia 
to jump	nhảy 
to keep	để giữ 
to kick	đá 
to kill	giết 
to kiss	hôn 
to kneel	quỳ 
to knock	gõ cửa 
to know	để biết 
to laugh	cười 
to lay	đẻ 
to lead	để lãnh đạo 
to lean	nạc 
to leap	nhảy vọt 
to learn	học 
to leave	rời đi 
to let	hãy để 
to lie	nói dối 
to lift	nâng 
to listen	nghe 
to live	sống 
to load	để tải 
to lock	khóa 
to look	nhìn 
to lose	mất 
to love	yêu 
to lower	để hạ thấp 
to maintain	để duy trì 
to make	để làm cho 
to manage	để quản lý 
to march	diễu hành 
to mark	đánh dấu 
to marry	cươi 
to may	để có thể 
to mean	có nghĩa là 
to meet	để gặp 
to mention	đề cập đến 
to might	để có thể 
to miss	bỏ lỡ 
tomorrow	Ngày mai 
to mount	để gắn kết 
to move	để di chuyển 
to murmur	để thì thầm 
to must	phải 
to mutter	lẩm bẩm 
to need	cần 
tone	tấn 
tongue	lưỡi 
tonight	tối nay 
to nod	gật đầu 
to notice	để ý 
to oblige	hai nghĩa vụ 
to observe	để quan sát 
to obtain	để có được 
to occupy	chiếm giữ 
to occur	xảy ra 
to offer	để cung cấp 
to open	mở 
too	quá 
tooth	răng 
to ought	nên 
to owe	để lò 
to pack	đóng gói 
to paint	vẽ 
to pass	vượt qua 
to pat	vỗ 
to pause	để tạm dừng 
to pay	trả 
to peer	để ngang hàng 
to perceive	để nhận thức 
to perform	để thực hiện 
to permit	cho phép 
to persuade	hai thuyết phục 
top	hàng đầu 
to pick	để chọn 
to pin	để ghim 
to play	chơi 
to please	làm ơn 
to pop	bật 
to possess	chiếm hữu 
to pour	đổ 
to pray	cầu nguyện 
to prefer	thích 
to prepare	chuẩn bị 
to press	nhấn 
to pretend	giả vờ 
to prevent	để ngăn chặn 
to proceed	tiến hành 
to produce	để sản xuất 
to promise	hứa 
to propose	đề xuất 
to protect	để bảo vệ 
to protest	để phản đối 
to prove	để chứng minh 
to provide	cung cấp 
to pull	để kéo 
to pursue	theo đuổi 
to push	đẩy 
to put	để đặt 
to raise	nâng cao 
to reach	để đạt được 
to read	đọc 
to realize	nhận ra 
to recall	nhớ lại 
to receive	Nhận 
to recognize	nhận ra 
to recover	để phục hồi 
to refer	để tham khảo 
to reflect	để phản ánh 
to refuse	từ chối 
to regard	liên quan 
to regret	hối tiếc 
to relate	liên quan 
to relax	thư giãn 
to release	phát hành 
to relieve	để giảm bớt 
to remain	ở lại 
to remark	để nhận xét 
to remember	nhớ 
to remind	nhắc nhở 
to remove	để loại bỏ 
to render	hai kết xuất 
to rent	để làm sạch 
to repeat	lặp lại 
to replace	để thay thế 
to reply	Phản hồi 
to represent	đại diện 
to require	yêu cầu 
to resist	để chống lại 
to resolve	để giải quyết 
to respond	để trả lời 
to retreat	rút lui 
to return	trở về 
to reveal	tiết lộ 
to ride	cưỡi 
to rise	tăng lên 
to roar	gầm 
to roll	để cuộn 
to rub	chà 
to ruin	hủy hoại 
to run	chạy 
to rush	vội vàng 
to sail	đi thuyền 
to satisfy	để thỏa mãn 
to save	để tiết kiệm 
to say	để nói 
to scare	sợ hãi 
to scratch	cào 
to scream	hét 
to search	tìm kiếm 
to secure	để bảo đảm 
to seek	tìm kiếm 
to seem	dường như 
to see	nhìn 
to seize	để nắm bắt 
to sell	bán 
to send	để gửi 
to separate	tách ra 
to serve	phục vụ 
to set	để thiết lập 
to settle	giải quyết 
to shake	lắc 
to shall	để 
to share	chia sẻ 
to shed	đổ 
to shift	thay đổi 
to shine	tỏa sáng 
to shiver	hai rùng mình 
to shoot	bắn 
to shout	la hét 
to shove	xô đẩy 
to show	để hiển thị 
to shrug	nhún vai 
to shut	đóng 
to sigh	thở dài 
to sing	hát 
to sink	để chìm 
to sip	nhấm nháp 
to sit	ngồi 
to slam	bùn 
to slap	đi ngủ 
to sleep	ngủ 
to slide	trượt 
to slip	trượt 
to smell	ngửi 
to smile	Để cười 
to snap	để chụp 
to sob	khóc nức nở 
to spare	để tiết kiệm 
to speak	nói 
to spend	chi tiêu 
to spin	quay 
to spread	lây lan 
to squeeze	bóp 
to stand	đứng 
to stare	nhìn chằm chằm 
to start	để bắt đầu 
to startle	giật mình 
to stay	ở lại 
to steal	để ăn cắp 
to stick	dính 
to stir	khuấy 
to stop	dừng lại 
to strain	căng thẳng 
to stretch	để căng 
to stride	chiến đấu 
to strike	để tấn công 
to strip	lột đồ 
to struggle	đấu tranh 
to study	học 
to succeed	để thành công 
to suffer	đau khổ 
to suggest	đề nghị 
to support	hỗ trợ 
to suppose	giả sử 
to surprise	ngạc nhiên 
to surround	bao quanh 
to survive	để tồn tại 
to suspect	để nghi ngờ 
to swallow	nuốt 
to swear	thề 
to sweep	quét 
to swell	sưng lên 
to swim	bơi 
to swing	lung lay 
to switch	để chuyển đổi 
to take	để lấy 
to talk	nói chuyện 
totally	hoàn toàn 
total	tổng 
to tap	hai mất mát 
to teach	dạy 
to tell	nói 
to tend	có xu hướng 
to thank	để cảm ơn 
to think	Để nghĩ 
to threaten	đe dọa 
to throw	ném 
to thrust	để đẩy 
to tie	buộc 
to tire	để lốp 
to toss	quăng 
to touch	chạm 
to travel	đi du lịch 
to treat	để điều trị 
to tremble	run sợ 
to trust	tin tưởng 
to try	thử 
to turn	biến 
to twist	xoắn 
to understand	hiểu 
to upset	buồn bã 
to urge	thúc giục 
to use	sử dụng 
to utter	để nói 
to vanish	biến mất 
to venture	liên doanh 
to visit	đến thăm 
to wait	đợi 
to wake	thức dậy 
to walk	đi bộ 
to wander	đi lang thang 
to want	muốn 
towards	hướng tới 
toward	về phía 
to warn	để cảnh báo 
to wash	để rửa 
to waste	lãng phí 
to watch	xem 
to wear	mặc 
to weep	khóc 
tower	tháp 
to whip	quất 
to whisper	thì thầm 
to whistle	huýt sáo 
to will	sẽ 
to win	để thắng 
to wipe	lau 
to wish	ước 
to withdraw	rút tiền 
town	thị trấn 
to wonder	băn khoăn 
to work	làm việc 
to worry	lo lắng 
to wrap	để bọc 
to write	viết 
to yell	hét lên 
trace	dấu vết 
track	theo dõi 
trade	thương mại 
tradition	truyền thống 
trail	đường mòn 
train	xe lửa 
trap	bẩy 
tree	cây 
trial	thử nghiệm 
trick	lừa 
trip	chuyến đi 
trouble	rắc rối 
truck	xe tải 
true	thật 
truly	thật sự 
trunk	thân cây 
truth	sự thật 
twelve	mười hai 
twenty	hai mươi 
twice	hai lần 
two	hai 
type	loại 
ugly	xấu xí 
unable	không thể 
uncle	chú 
under	Dưới 
understanding	hiểu biết 
uniform	đồng dạng 
unknown	không biết 
unless	trừ khi 
until	cho đến khi 
unusual	bất thường 
up	lên 
upon	trên 
upper	ups 
upstairs	lên lầu 
us	chúng tôi 
usual	bình thường 
usually	thông thường 
valley	thung lũng 
value	giá trị 
various	khác nhau 
vast	rộng lớn 
vehicle	xe cộ 
version	phiên bản 
very	rất 
vessel	tàu 
victim	nạn nhân 
view	lượt xem 
village	làng 
virtue	đức 
visible	có thể thấy 
vision	tầm nhìn 
visitor	người truy cập 
voice	tiếng nói 
volume	thể tích 
wagon	toa xe 
waist	thắt lưng 
wall	Tường 
war	chiến tranh 
warm	ấm áp 
warmth	hơi nóng 
warning	cảnh báo 
warrior	quân nhân 
water	Nước 
wave	làn sóng 
way	đường 
weak	yếu 
weapon	vũ khí 
weather	thời tiết 
we	chúng tôi 
wedding	đám cưới 
week	tuần 
weight	trọng lượng 
welcome	chào mừng 
well	tốt 
west	tây 
wet	luật 
whatever	bất cứ điều gì 
what	gì 
wheel	bánh xe 
whenever	Nar bao giờ hết 
when	khi nào 
where	Ở đâu 
whether	liệu 
which	mà 
while	trong khi 
white	trắng 
whole	toàn bộ 
whom	ai 
who	người nào 
whose	của ai 
why	tại sao 
wide	rộng 
wife	người vợ 
wild	hoang dã 
willing	sẵn sàng 
wind	gió 
window	cửa sổ 
wine	rượu nho 
wing	cánh 
winter	mùa đông 
wire	dây thép 
wise	khôn ngoan 
within	trong 
without	không có 
with	với 
witness	nhân chứng 
woman	đàn bà 
wonderful	tuyệt vời 
wooden	gỗ 
wood	gỗ 
word	từ 
worker	công nhân 
world	thế giới 
worth	giá trị 
wound	vết thương 
wrist	cổ tay 
writer	nhà văn 
writing	viết 
wrong	sai rồi 
yard	sân 
year	năm 
yellow	màu vàng 
yesterday	hôm qua 
yes	Vâng 
yet	chưa 
you	bạn 
young	trẻ 
your	của bạn 
yours	của bạn 
yourself	bản thân bạn 
youth	tuổi trẻ 
